//MAP CONVERTED BY dmm2tgm.py THIS HEADER COMMENT PREVENTS RECONVERSION, DO NOT REMOVE
"aM" = (
/obj/machinery/seeder,
/obj/effect/decal/cleanable/dirt,
/turf/open/floor/iron,
/area/ruin/powered)
"aW" = (
/turf/template_noop,
/area/template_noop)
"bz" = (
/obj/effect/spawner/structure/window/reinforced,
/turf/open/floor/plating,
/area/ruin/powered)
"ca" = (
/obj/machinery/door/airlock/security/glass{
	name = "Long-Term Cell 1"
	},
/obj/effect/mapping_helpers/airlock/access/all/security/brig,
/obj/structure/cable/yellow,
/obj/effect/mapping_helpers/airlock/cyclelink_helper{
	dir = 1
	},
/obj/effect/decal/cleanable/dirt,
/turf/open/floor/iron,
/area/ruin/powered)
"ck" = (
/obj/machinery/shower{
	dir = 8
	},
/obj/item/soap/nanotrasen,
/turf/open/floor/iron/freezer,
/area/ruin/powered)
"cw" = (
/obj/structure/window/reinforced/spawner/directional/north,
/obj/effect/turf_decal/tile/blue/opposingcorners{
	dir = 1
	},
/turf/open/floor/iron/cafeteria,
/area/ruin/powered)
"dF" = (
/obj/structure/closet/secure_closet/brig,
/obj/effect/turf_decal/tile/red/half/contrasted{
	dir = 8
	},
/turf/open/floor/iron,
/area/ruin/powered)
"em" = (
/obj/structure/sink/directional/east,
/turf/open/floor/iron/freezer,
/area/ruin/powered)
"ev" = (
/obj/structure/bookcase,
/obj/effect/decal/cleanable/dirt,
/turf/open/floor/iron,
/area/ruin/powered)
"fJ" = (
/obj/structure/table,
/obj/effect/spawner/random/ruinloot/security,
/obj/effect/spawner/random/ruinloot/security,
/turf/open/floor/iron,
/area/ruin/powered)
"fP" = (
/obj/effect/decal/cleanable/dirt,
/turf/open/floor/iron,
/area/ruin/powered)
"gY" = (
/turf/open/floor/plating,
/area/ruin/powered)
"hV" = (
/obj/item/reagent_containers/cup/bucket,
/turf/open/floor/plating,
/area/ruin/powered)
"hY" = (
/turf/closed/wall/r_wall,
/area/ruin/powered)
"iQ" = (
/obj/machinery/door/airlock{
	name = "Unisex Restroom"
	},
/turf/open/floor/iron/freezer,
/area/ruin/powered)
"jw" = (
/obj/machinery/holopad,
/obj/effect/decal/cleanable/dirt,
/turf/open/floor/iron,
/area/ruin/powered)
"kV" = (
/obj/machinery/door/airlock/public/glass{
	id_tag = "permabolt3";
	name = "Cell 3"
	},
/obj/effect/mapping_helpers/airlock/cyclelink_helper,
/obj/effect/decal/cleanable/dirt,
/turf/open/floor/iron,
/area/ruin/powered)
"lm" = (
/obj/structure/chair/stool/directional/west,
/obj/effect/decal/cleanable/dirt,
/turf/open/floor/iron,
/area/ruin/powered)
"ls" = (
/obj/effect/decal/cleanable/dirt,
/turf/closed/wall/r_wall,
/area/ruin/powered)
"lQ" = (
/obj/item/plant_tray/soil,
/obj/item/plant_seeds/preset/ambrosia,
/obj/effect/turf_decal/tile/green/anticorner/contrasted{
	dir = 1
	},
/turf/open/floor/iron,
/area/ruin/powered)
"mK" = (
/obj/machinery/washing_machine,
/obj/structure/window/reinforced/spawner/directional/south,
/obj/effect/turf_decal/tile/blue/opposingcorners{
	dir = 1
	},
/turf/open/floor/iron/cafeteria,
/area/ruin/powered)
"nk" = (
/obj/structure/table,
/obj/item/razor{
	pixel_x = -6
	},
/obj/machinery/atmospherics/components/unary/vent_scrubber/on/layer4{
	dir = 1
	},
/obj/effect/spawner/random/ruinloot/security,
/obj/effect/turf_decal/tile/red/half/contrasted{
	dir = 8
	},
/turf/open/floor/iron,
/area/ruin/powered)
"ob" = (
/obj/structure/chair/stool,
/obj/effect/decal/cleanable/dirt,
/turf/open/floor/iron,
/area/ruin/powered)
"oP" = (
/obj/machinery/light,
/obj/effect/decal/cleanable/dirt,
/obj/machinery/vending/sustenance,
/turf/open/floor/iron,
/area/ruin/powered)
"rg" = (
/mob/living/basic/mouse/brown/tom,
/turf/open/floor/plating,
/area/ruin/powered)
"uJ" = (
/obj/structure/bed,
/obj/effect/decal/cleanable/dirt,
/obj/item/toy/plush/carpplushie,
/turf/open/floor/iron,
/area/ruin/powered)
"uP" = (
/obj/machinery/light{
	dir = 8
	},
/turf/open/floor/plating,
/area/ruin/powered)
"vZ" = (
/obj/effect/decal/cleanable/dirt,
/obj/effect/spawner/random/vending/colavend,
/turf/open/floor/iron,
/area/ruin/powered)
"xk" = (
/obj/structure/extinguisher_cabinet{
	pixel_x = 1;
	pixel_y = -27
	},
/obj/effect/turf_decal/tile/red/half/contrasted{
	dir = 8
	},
/turf/open/floor/iron,
/area/ruin/powered)
"xZ" = (
/obj/machinery/biogenerator,
/obj/effect/decal/cleanable/dirt,
/turf/open/floor/iron,
/area/ruin/powered)
"Al" = (
/obj/effect/decal/cleanable/dirt,
/obj/effect/spawner/random/entertainment/arcade,
/turf/open/floor/iron,
/area/ruin/powered)
"Ba" = (
/obj/effect/decal/cleanable/dirt,
/obj/structure/bed,
/turf/open/floor/iron,
/area/ruin/powered)
"Cn" = (
/obj/structure/table,
/obj/item/storage/pill_bottle/dice,
/turf/open/floor/iron,
/area/ruin/powered)
"CI" = (
/turf/open/floor/iron/freezer,
/area/ruin/powered)
"Dr" = (
/obj/structure/window/reinforced/spawner/directional/south,
/obj/effect/turf_decal/tile/blue/opposingcorners{
	dir = 1
	},
/turf/open/floor/iron/cafeteria,
/area/ruin/powered)
"DE" = (
/obj/machinery/door/airlock/security/glass{
	name = "Long-Term Cell 3"
	},
/obj/effect/mapping_helpers/airlock/access/all/security/brig,
/obj/effect/mapping_helpers/airlock/cyclelink_helper{
	dir = 1
	},
/obj/effect/decal/cleanable/dirt,
/turf/open/floor/iron,
/area/ruin/powered)
"Ec" = (
/obj/structure/sign/warning/electric_shock{
	pixel_y = 32
	},
/obj/item/plant_tray/soil,
/obj/item/plant_scanner,
/obj/machinery/camera/directional/north,
/obj/effect/turf_decal/tile/green/anticorner/contrasted{
	dir = 4
	},
/turf/open/floor/iron,
/area/ruin/powered)
"Ej" = (
/obj/structure/table,
/obj/item/pen,
/obj/effect/spawner/random/ruinloot/security,
/turf/open/floor/iron,
/area/ruin/powered)
"Gd" = (
/obj/effect/decal/cleanable/dirt,
/obj/machinery/door/window/westleft{
	base_state = "right";
	icon_state = "right";
	name = "Unisex Showers"
	},
/turf/open/floor/iron/freezer,
/area/ruin/powered)
"Gk" = (
/obj/effect/abstract/doorway_marker,
/turf/open/floor/iron/dark,
/area/ruin/powered)
"Hh" = (
/obj/effect/turf_decal/tile/red{
	dir = 8
	},
/turf/open/floor/iron,
/area/ruin/powered)
"Hi" = (
/obj/item/plant_tray/pot/random,
/obj/effect/turf_decal/tile/red/half/contrasted{
	dir = 8
	},
/turf/open/floor/iron,
/area/ruin/powered)
"Ho" = (
/obj/structure/table,
/obj/structure/bedsheetbin,
/obj/effect/turf_decal/tile/blue/opposingcorners{
	dir = 1
	},
/turf/open/floor/iron/cafeteria,
/area/ruin/powered)
"HS" = (
/obj/structure/toilet{
	dir = 1
	},
/turf/open/floor/iron/freezer,
/area/ruin/powered)
"Jj" = (
/obj/item/plant_tray/soil,
/obj/item/plant_seeds/preset/glowshroom,
/obj/effect/turf_decal/tile/green/half/contrasted{
	dir = 4
	},
/turf/open/floor/iron,
/area/ruin/powered)
"Kl" = (
/obj/structure/rack,
/obj/effect/spawner/random/ruinloot/security,
/obj/effect/turf_decal/tile/red,
/turf/open/floor/iron,
/area/ruin/powered)
"Kw" = (
/obj/structure/table,
/obj/item/paper_bin{
	pixel_x = -3;
	pixel_y = 7
	},
/obj/item/pen,
/turf/open/floor/iron,
/area/ruin/powered)
"KD" = (
/obj/effect/decal/cleanable/dirt,
/obj/structure/window/reinforced/spawner/directional/west,
/turf/open/floor/iron/freezer,
/area/ruin/powered)
"Lz" = (
/obj/item/plant_tray/soil,
/obj/item/plant_seeds/preset/carrot,
/obj/effect/turf_decal/tile/green/half/contrasted{
	dir = 4
	},
/turf/open/floor/iron,
/area/ruin/powered)
"LR" = (
/obj/structure/table,
/obj/item/paper,
/obj/item/pen,
/obj/effect/decal/cleanable/dirt,
/turf/open/floor/iron,
/area/ruin/powered)
"Mk" = (
/obj/structure/window/reinforced/spawner/directional/south,
/obj/item/plant_tray/soil,
/obj/item/plant_seeds/preset/grass,
/obj/effect/turf_decal/tile/green/half/contrasted{
	dir = 8
	},
/turf/open/floor/iron,
/area/ruin/powered)
"Mm" = (
/obj/structure/window/reinforced/spawner/directional/south,
/turf/open/floor/plating,
/area/ruin/powered)
"MF" = (
/obj/machinery/door/airlock/public/glass{
	id_tag = "permabolt2";
	name = "Cell 2"
	},
/obj/effect/mapping_helpers/airlock/cyclelink_helper,
/obj/effect/decal/cleanable/dirt,
/turf/open/floor/iron,
/area/ruin/powered)
"ND" = (
/turf/closed/wall,
/area/ruin/powered)
"NN" = (
/obj/structure/window/reinforced/spawner/directional/south,
/obj/item/plant_tray/soil,
/obj/item/cultivator,
/obj/effect/turf_decal/tile/green/anticorner/contrasted,
/turf/open/floor/iron,
/area/ruin/powered)
"NQ" = (
/obj/structure/window/reinforced/spawner/directional/south,
/obj/item/plant_tray/soil,
/obj/item/cultivator,
/obj/effect/turf_decal/tile/green/half/contrasted{
	dir = 8
	},
/turf/open/floor/iron,
/area/ruin/powered)
"NV" = (
/obj/structure/window/reinforced/spawner/directional/south,
/obj/item/plant_tray/soil,
/obj/item/plant_seeds/preset/potato,
/obj/effect/turf_decal/tile/green/anticorner/contrasted{
	dir = 8
	},
/turf/open/floor/iron,
/area/ruin/powered)
"Oe" = (
/obj/structure/lattice,
/turf/template_noop,
/area/template_noop)
"Og" = (
/obj/effect/abstract/open_area_marker{
	dir = 4
	},
/turf/open/floor/iron,
/area/ruin/powered)
"On" = (
/obj/machinery/door/airlock/security/glass{
	name = "Long-Term Cell 2"
	},
/obj/effect/mapping_helpers/airlock/access/all/security/brig,
/obj/effect/mapping_helpers/airlock/cyclelink_helper{
	dir = 1
	},
/obj/effect/decal/cleanable/dirt,
/turf/open/floor/iron,
/area/ruin/powered)
"Os" = (
/obj/effect/turf_decal/tile/blue/opposingcorners{
	dir = 1
	},
/turf/open/floor/iron/cafeteria,
/area/ruin/powered)
"Ot" = (
/obj/effect/turf_decal/tile/red/half/contrasted{
	dir = 8
	},
/turf/open/floor/iron,
/area/ruin/powered)
"OW" = (
/obj/machinery/washing_machine,
/obj/structure/window/reinforced/spawner/directional/north,
/obj/effect/turf_decal/tile/blue/opposingcorners{
	dir = 1
	},
/turf/open/floor/iron/cafeteria,
/area/ruin/powered)
"QP" = (
/obj/effect/decal/cleanable/dirt,
/obj/structure/table,
/obj/item/paper,
/obj/item/pen,
/turf/open/floor/iron,
/area/ruin/powered)
"QT" = (
/obj/structure/table,
/obj/item/toy/cards/deck,
/turf/open/floor/iron,
/area/ruin/powered)
"RI" = (
/obj/structure/sink/directional/north,
/turf/open/floor/plating,
/area/ruin/powered)
"RQ" = (
/obj/structure/bed,
/obj/effect/decal/cleanable/dirt,
/turf/open/floor/iron,
/area/ruin/powered)
"Tp" = (
/obj/effect/decal/cleanable/dirt,
/turf/closed/wall,
/area/ruin/powered)
"Tu" = (
/obj/structure/table,
/obj/item/electropack,
/obj/effect/turf_decal/tile/red/half/contrasted{
	dir = 8
	},
/turf/open/floor/iron,
/area/ruin/powered)
"Ul" = (
/obj/effect/abstract/open_area_marker{
	dir = 8
	},
/turf/open/floor/iron,
/area/ruin/powered)
"Vd" = (
/obj/machinery/computer/libraryconsole/bookmanagement,
/obj/structure/table,
/obj/effect/decal/cleanable/dirt,
/turf/open/floor/iron,
/area/ruin/powered)
"Xg" = (
/turf/open/floor/iron,
/area/ruin/powered)
"ZI" = (
/obj/machinery/door/airlock/public/glass{
	id_tag = "permabolt1";
	name = "Cell 1"
	},
/obj/effect/mapping_helpers/airlock/cyclelink_helper,
/obj/effect/decal/cleanable/dirt,
/turf/open/floor/iron,
/area/ruin/powered)

(1,1,1) = {"
Oe
Oe
Oe
hY
hY
hY
ls
ls
ls
hY
ls
ls
ND
Xg
Ul
Kl
ND
"}
(2,1,1) = {"
hY
hY
hY
hY
ev
Vd
fP
fP
fP
kV
fP
fP
DE
Xg
Xg
xk
ND
"}
(3,1,1) = {"
hY
lQ
uP
NV
fP
lm
fP
jw
vZ
ND
Ba
LR
ND
Xg
Xg
Ot
Gk
"}
(4,1,1) = {"
bz
Lz
gY
Mk
fP
fP
fP
fP
oP
ND
ND
ND
ND
Xg
Xg
Hi
ND
"}
(5,1,1) = {"
hY
gY
rg
Mm
fP
fP
lm
fP
fP
ND
RQ
fP
ND
Xg
Xg
Tu
ND
"}
(6,1,1) = {"
bz
Jj
gY
NQ
fP
Cn
QT
fP
fP
MF
fP
fP
On
Xg
Xg
nk
ND
"}
(7,1,1) = {"
hY
Ec
gY
NN
ob
Ej
Kw
fP
fP
ND
ob
LR
ND
Xg
Xg
fJ
ND
"}
(8,1,1) = {"
bz
fP
gY
fP
fP
lm
fP
fP
fP
ND
ND
ND
ND
Xg
Xg
dF
ND
"}
(9,1,1) = {"
hY
RI
hV
fP
fP
fP
fP
fP
fP
ND
uJ
QP
ND
Xg
Xg
dF
ND
"}
(10,1,1) = {"
bz
fP
fP
fP
cw
Os
Dr
Al
fP
ZI
fP
fP
ca
Xg
Xg
dF
ND
"}
(11,1,1) = {"
hY
xZ
aM
fP
OW
Ho
mK
KD
Gd
ND
Tp
Tp
ND
Xg
Xg
Hh
ND
"}
(12,1,1) = {"
hY
hY
hY
hY
hY
hY
hY
ck
CI
iQ
em
HS
ND
Xg
Xg
Xg
ND
"}
(13,1,1) = {"
aW
aW
Oe
Oe
aW
Oe
hY
hY
hY
hY
hY
hY
hY
Xg
Og
Xg
ND
"}
