//MAP CONVERTED BY dmm2tgm.py THIS HEADER COMMENT PREVENTS RECONVERSION, DO NOT REMOVE
"bZ" = (
/obj/effect/abstract/open_area_marker,
/turf/open/floor/iron,
/area/ruin/powered)
"dB" = (
/obj/effect/spawner/random/ruinloot/science,
/obj/effect/turf_decal/tile/purple,
/turf/open/floor/iron/white,
/area/ruin/powered)
"en" = (
/obj/item/plant_tray/pot/random,
/obj/machinery/light,
/obj/effect/turf_decal/tile/purple/half/contrasted{
	dir = 8
	},
/turf/open/floor/iron/white,
/area/ruin/powered)
"gt" = (
/obj/effect/turf_decal/tile/purple/anticorner/contrasted,
/turf/open/floor/iron/white,
/area/ruin/powered)
"iH" = (
/obj/effect/turf_decal/tile/purple/half/contrasted{
	dir = 4
	},
/turf/open/floor/iron/white,
/area/ruin/powered)
"iU" = (
/obj/effect/turf_decal/tile/purple/anticorner/contrasted{
	dir = 1
	},
/turf/open/floor/iron/white,
/area/ruin/powered)
"iX" = (
/obj/effect/turf_decal/tile/purple/fourcorners/contrasted,
/turf/open/floor/iron/white,
/area/ruin/powered)
"jZ" = (
/obj/effect/turf_decal/stripes/line{
	dir = 8
	},
/obj/effect/turf_decal/tile/purple/half/contrasted{
	dir = 1
	},
/turf/open/floor/iron/white,
/area/ruin/powered)
"kr" = (
/obj/effect/turf_decal/tile/purple/anticorner/contrasted{
	dir = 8
	},
/turf/open/floor/iron/white,
/area/ruin/powered)
"na" = (
/obj/effect/turf_decal/stripes/line{
	dir = 8
	},
/obj/effect/turf_decal/tile/purple/opposingcorners,
/turf/open/floor/iron,
/area/ruin/powered)
"oN" = (
/obj/effect/turf_decal/stripes/line{
	dir = 4
	},
/obj/machinery/computer/rdconsole/unlocked{
	dir = 1
	},
/obj/effect/turf_decal/tile/purple/opposingcorners,
/turf/open/floor/iron,
/area/ruin/powered)
"pl" = (
/obj/effect/turf_decal/tile/purple/anticorner/contrasted{
	dir = 4
	},
/turf/open/floor/iron/white,
/area/ruin/powered)
"pw" = (
/turf/open/floor/iron/white,
/area/ruin/powered)
"pY" = (
/obj/effect/turf_decal/tile/purple/half/contrasted{
	dir = 1
	},
/turf/open/floor/iron/white,
/area/ruin/powered)
"rk" = (
/turf/open/floor/iron,
/area/ruin/powered)
"sp" = (
/obj/effect/turf_decal/tile/purple/half/contrasted,
/turf/open/floor/iron/white,
/area/ruin/powered)
"sM" = (
/obj/effect/turf_decal/stripes/line{
	dir = 9
	},
/obj/machinery/rnd/production/protolathe/department/science,
/obj/effect/turf_decal/tile/purple/opposingcorners,
/turf/open/floor/iron,
/area/ruin/powered)
"te" = (
/obj/effect/turf_decal/stripes/line{
	dir = 10
	},
/obj/machinery/computer/cargo/request{
	dir = 8
	},
/obj/effect/turf_decal/tile/purple/opposingcorners,
/turf/open/floor/iron,
/area/ruin/powered)
"tg" = (
/obj/machinery/door/airlock/science,
/turf/open/floor/iron/white,
/area/ruin/powered)
"us" = (
/obj/effect/spawner/structure/window,
/turf/open/floor/plating,
/area/ruin/powered)
"xO" = (
/obj/effect/turf_decal/stripes/corner{
	dir = 1
	},
/obj/effect/turf_decal/tile/purple/half/contrasted{
	dir = 1
	},
/turf/open/floor/iron/white,
/area/ruin/powered)
"Bd" = (
/obj/effect/turf_decal/stripes/line{
	dir = 8
	},
/obj/machinery/rnd/destructive_analyzer,
/obj/effect/turf_decal/tile/purple/opposingcorners,
/turf/open/floor/iron,
/area/ruin/powered)
"Ea" = (
/obj/machinery/vending/wardrobe/science_wardrobe,
/obj/effect/turf_decal/tile/purple/anticorner/contrasted{
	dir = 4
	},
/turf/open/floor/iron/white,
/area/ruin/powered)
"EF" = (
/obj/effect/turf_decal/stripes/line{
	dir = 5
	},
/obj/structure/table,
/obj/item/hand_labeler,
/obj/effect/spawner/random/ruinloot/science,
/obj/effect/turf_decal/tile/purple/opposingcorners,
/turf/open/floor/iron,
/area/ruin/powered)
"Fl" = (
/obj/effect/turf_decal/stripes/line{
	dir = 8
	},
/obj/structure/table,
/obj/machinery/cell_charger,
/obj/item/stock_parts/cell/high,
/obj/effect/turf_decal/tile/purple/opposingcorners,
/turf/open/floor/iron,
/area/ruin/powered)
"GH" = (
/obj/effect/turf_decal/stripes/line{
	dir = 4
	},
/obj/structure/table,
/obj/structure/window/reinforced/spawner/directional/south,
/obj/item/circuitboard/computer/nanite_chamber_control,
/obj/item/circuitboard/computer/nanite_cloud_controller,
/obj/item/circuitboard/machine/nanite_chamber,
/obj/item/circuitboard/machine/nanite_program_hub,
/obj/effect/spawner/random/ruinloot/science,
/obj/effect/spawner/random/ruinloot/science,
/obj/effect/turf_decal/tile/purple/opposingcorners,
/turf/open/floor/iron,
/area/ruin/powered)
"Li" = (
/obj/structure/chair/stool,
/obj/effect/turf_decal/tile/purple/half/contrasted{
	dir = 1
	},
/turf/open/floor/iron/white,
/area/ruin/powered)
"Lv" = (
/obj/effect/turf_decal/stripes/corner{
	dir = 8
	},
/obj/structure/chair/stool,
/obj/effect/turf_decal/tile/purple/half/contrasted{
	dir = 1
	},
/turf/open/floor/iron/white,
/area/ruin/powered)
"Ne" = (
/obj/effect/turf_decal/tile/purple,
/turf/open/floor/iron/white,
/area/ruin/powered)
"Og" = (
/turf/closed/wall,
/area/ruin/powered)
"OW" = (
/obj/item/plant_tray/pot/random,
/obj/effect/turf_decal/tile/purple/anticorner/contrasted{
	dir = 8
	},
/turf/open/floor/iron/white,
/area/ruin/powered)
"Py" = (
/obj/effect/turf_decal/stripes/line{
	dir = 8
	},
/obj/structure/table,
/obj/item/disk/tech_disk{
	pixel_x = -2;
	pixel_y = -3
	},
/obj/item/disk/tech_disk{
	pixel_x = -2;
	pixel_y = -3
	},
/obj/item/disk/design_disk,
/obj/machinery/light{
	dir = 4
	},
/obj/effect/spawner/random/ruinloot/science,
/obj/effect/spawner/random/ruinloot/science,
/obj/effect/turf_decal/tile/purple/opposingcorners,
/turf/open/floor/iron,
/area/ruin/powered)
"QW" = (
/obj/structure/table/reinforced,
/obj/item/paper_bin,
/obj/item/pen,
/obj/machinery/door/firedoor,
/turf/open/floor/iron/white,
/area/ruin/powered)
"Ra" = (
/obj/effect/abstract/doorway_marker{
	dir = 8
	},
/turf/open/floor/iron/white,
/area/ruin/powered)
"Sv" = (
/obj/effect/turf_decal/stripes/line{
	dir = 5
	},
/obj/machinery/rnd/production/circuit_imprinter/department/science,
/obj/effect/turf_decal/tile/purple/opposingcorners,
/turf/open/floor/iron,
/area/ruin/powered)
"SK" = (
/obj/effect/turf_decal/stripes/line{
	dir = 4
	},
/obj/effect/turf_decal/tile/purple/opposingcorners,
/turf/open/floor/iron,
/area/ruin/powered)
"SY" = (
/obj/effect/turf_decal/tile/purple{
	dir = 4
	},
/turf/open/floor/iron/white,
/area/ruin/powered)
"Uq" = (
/obj/effect/turf_decal/stripes/line{
	dir = 8
	},
/obj/structure/table,
/obj/item/folder/white{
	pixel_x = 4;
	pixel_y = 4
	},
/obj/item/folder/white{
	pixel_x = 4;
	pixel_y = 4
	},
/obj/item/crowbar,
/obj/effect/spawner/random/ruinloot/science,
/obj/effect/spawner/random/ruinloot/science,
/obj/effect/turf_decal/tile/purple/opposingcorners,
/turf/open/floor/iron,
/area/ruin/powered)
"VI" = (
/obj/machinery/door/window/eastleft{
	name = "Research and Development Deliveries";
	req_one_access_txt = "7;29"
	},
/obj/effect/turf_decal/delivery,
/turf/open/floor/iron,
/area/ruin/powered)
"Xd" = (
/obj/effect/spawner/random/ruinloot/science,
/turf/open/floor/iron/white,
/area/ruin/powered)
"Xu" = (
/obj/effect/spawner/random/ruinloot/important,
/turf/open/floor/iron/white,
/area/ruin/powered)
"Yv" = (
/obj/effect/abstract/open_area_marker{
	dir = 1
	},
/turf/open/floor/iron,
/area/ruin/powered)
"YD" = (
/obj/effect/turf_decal/tile/purple/half/contrasted{
	dir = 8
	},
/turf/open/floor/iron/white,
/area/ruin/powered)
"YQ" = (
/obj/effect/turf_decal/stripes/line{
	dir = 6
	},
/obj/structure/table,
/obj/structure/window/reinforced/spawner/directional/north,
/obj/item/clothing/glasses/science,
/obj/effect/spawner/random/ruinloot/science,
/obj/effect/turf_decal/tile/purple/opposingcorners,
/turf/open/floor/iron,
/area/ruin/powered)
"ZX" = (
/obj/structure/table,
/obj/item/stack/sheet/iron/fifty,
/obj/effect/turf_decal/stripes/end,
/obj/item/clothing/glasses/welding,
/turf/open/floor/iron,
/area/ruin/powered)

(1,1,1) = {"
Og
Og
Og
Og
Og
Og
Ra
Og
Og
"}
(2,1,1) = {"
Og
iX
EF
GH
VI
YQ
pw
iX
Og
"}
(3,1,1) = {"
Og
iU
Li
Lv
jZ
xO
pw
kr
Og
"}
(4,1,1) = {"
Og
iH
Xu
pw
Ne
dB
Ne
en
Og
"}
(5,1,1) = {"
Og
pl
SY
pw
YD
sM
na
Bd
Og
"}
(6,1,1) = {"
Og
ZX
iH
Xd
YD
Sv
SK
oN
Og
"}
(7,1,1) = {"
Og
iX
pl
sp
gt
iU
pY
OW
Og
"}
(8,1,1) = {"
Og
Uq
Fl
Py
te
Ea
sp
gt
Og
"}
(9,1,1) = {"
Og
Og
us
us
us
Og
QW
tg
Og
"}
(10,1,1) = {"
rk
rk
rk
rk
rk
rk
rk
rk
rk
"}
(11,1,1) = {"
Yv
rk
rk
rk
rk
rk
rk
rk
bZ
"}
(12,1,1) = {"
rk
rk
rk
rk
rk
rk
rk
rk
rk
"}
(13,1,1) = {"
Og
Og
Og
Og
Og
Og
Og
Og
Og
"}
