//MAP CONVERTED BY dmm2tgm.py THIS HEADER COMMENT PREVENTS RECONVERSION, DO NOT REMOVE
"o" = (
/obj/machinery/door/airlock/external/glass,
/obj/structure/fans/tiny,
/turf/open/floor/iron,
/area/ruin/powered)
"s" = (
/turf/open/floor/iron,
/area/ruin/powered)
"x" = (
/obj/effect/abstract/open_area_marker{
	dir = 4
	},
/turf/open/floor/iron,
/area/ruin/powered)
"y" = (
/obj/item/plant_tray/pot/random,
/turf/open/floor/iron,
/area/ruin/powered)
"z" = (
/obj/effect/spawner/structure/window/reinforced,
/turf/open/floor/plating,
/area/ruin/powered)
"A" = (
/turf/template_noop,
/area/template_noop)
"J" = (
/turf/closed/wall,
/area/ruin/powered)
"P" = (
/obj/effect/spawner/random/vending/colavend,
/turf/open/floor/iron,
/area/ruin/powered)
"Q" = (
/obj/effect/abstract/open_area_marker{
	dir = 8
	},
/turf/open/floor/iron,
/area/ruin/powered)
"R" = (
/obj/structure/fans/tiny,
/obj/effect/turf_decal/stripes/line,
/turf/open/floor/iron,
/area/ruin/powered)
"S" = (
/obj/effect/spawner/random/vending/snackvend,
/turf/open/floor/iron,
/area/ruin/powered)
"U" = (
/obj/structure/fans/tiny,
/obj/effect/turf_decal/stripes/line{
	dir = 1
	},
/turf/open/floor/iron,
/area/ruin/powered)

(1,1,1) = {"
J
J
J
J
J
J
J
J
J
J
J
J
J
s
Q
s
J
"}
(2,1,1) = {"
J
P
s
s
s
s
s
s
s
s
s
s
s
s
s
s
J
"}
(3,1,1) = {"
J
S
s
s
s
s
s
s
s
s
s
s
s
s
s
s
J
"}
(4,1,1) = {"
J
y
s
s
J
J
z
z
z
z
z
J
J
s
s
s
J
"}
(5,1,1) = {"
J
s
s
s
J
A
A
A
A
A
A
A
J
s
s
s
J
"}
(6,1,1) = {"
J
s
s
s
z
A
A
A
A
A
A
A
z
s
s
s
J
"}
(7,1,1) = {"
J
s
s
s
J
A
A
A
A
A
A
A
J
s
s
s
J
"}
(8,1,1) = {"
J
s
s
s
R
A
A
A
A
A
A
A
U
s
s
s
J
"}
(9,1,1) = {"
J
s
s
s
R
A
A
A
A
A
A
A
U
s
s
s
J
"}
(10,1,1) = {"
J
s
s
s
J
A
A
A
A
A
A
A
J
s
s
s
J
"}
(11,1,1) = {"
J
s
s
s
J
A
A
A
A
A
A
A
J
s
s
s
J
"}
(12,1,1) = {"
J
s
s
s
o
A
A
A
A
A
A
A
o
s
s
s
J
"}
(13,1,1) = {"
J
s
s
s
J
A
A
A
A
A
A
A
J
s
s
s
J
"}
(14,1,1) = {"
J
s
s
s
z
A
A
A
A
A
A
A
z
s
s
s
J
"}
(15,1,1) = {"
J
s
s
s
z
A
A
A
A
A
A
A
z
s
s
s
J
"}
(16,1,1) = {"
J
s
s
s
z
A
A
A
A
A
A
A
z
s
s
s
J
"}
(17,1,1) = {"
J
s
s
s
J
A
A
A
A
A
A
A
J
s
s
s
J
"}
(18,1,1) = {"
J
s
s
s
J
J
z
z
z
z
z
J
J
s
s
s
J
"}
(19,1,1) = {"
J
s
s
s
s
s
s
s
s
s
s
s
s
s
s
s
J
"}
(20,1,1) = {"
J
s
s
s
s
s
s
s
s
s
s
s
s
s
s
y
J
"}
(21,1,1) = {"
J
s
x
s
J
J
J
J
J
J
J
J
J
J
J
J
J
"}
