//MAP CONVERTED BY dmm2tgm.py THIS HEADER COMMENT PREVENTS RECONVERSION, DO NOT REMOVE
"au" = (
/obj/effect/turf_decal/stripes/line{
	dir = 1
	},
/turf/open/floor/iron,
/area/ruin/powered)
"aI" = (
/obj/effect/abstract/open_area_marker,
/turf/open/floor/iron,
/area/ruin/powered)
"bf" = (
/obj/machinery/door/airlock/maintenance_hatch,
/turf/open/floor/plating/airless,
/area/template_noop)
"bj" = (
/obj/structure/frame/computer,
/obj/effect/turf_decal/tile/blue/anticorner/contrasted{
	dir = 1
	},
/turf/open/floor/mineral/titanium/airless,
/area/template_noop)
"es" = (
/turf/template_noop/open,
/area/template_noop)
"eR" = (
/obj/structure/chair/fancy/shuttle{
	dir = 1
	},
/turf/open/floor/mineral/titanium/airless,
/area/template_noop)
"ib" = (
/obj/machinery/shuttle/engine/plasma{
	dir = 1
	},
/turf/open/floor/plating/airless,
/area/template_noop)
"ig" = (
/obj/structure/door_assembly/door_assembly_mhatch,
/turf/open/floor/plating/airless,
/area/template_noop)
"iR" = (
/obj/effect/turf_decal/stripes/line{
	dir = 1
	},
/turf/open/floor/plating/airless,
/area/template_noop)
"jO" = (
/obj/effect/turf_decal/stripes/line{
	dir = 1
	},
/obj/effect/turf_decal/tile/neutral/opposingcorners,
/turf/open/floor/iron,
/area/ruin/powered)
"lJ" = (
/obj/structure/closet/firecloset,
/obj/effect/turf_decal/stripes/line{
	dir = 8
	},
/turf/open/floor/iron,
/area/ruin/powered)
"mf" = (
/obj/structure/closet/firecloset,
/turf/open/floor/plating/airless,
/area/template_noop)
"mz" = (
/obj/structure/sign/nanotrasen{
	pixel_x = 32
	},
/obj/effect/turf_decal/tile/neutral/opposingcorners,
/turf/open/floor/iron,
/area/ruin/powered)
"nu" = (
/turf/open/floor/mineral/titanium/airless,
/area/template_noop)
"nT" = (
/obj/item/shuttle_creator,
/obj/machinery/light/built{
	dir = 8
	},
/obj/item/radio/intercom{
	pixel_y = -27
	},
/turf/open/floor/mineral/titanium/airless,
/area/template_noop)
"ob" = (
/obj/machinery/atmospherics/components/unary/portables_connector{
	dir = 8
	},
/obj/machinery/portable_atmospherics/canister/plasma,
/turf/open/floor/plating/airless,
/area/template_noop)
"qm" = (
/obj/machinery/door/airlock/external/glass,
/obj/effect/mapping_helpers/airlock/cyclelink_helper,
/turf/open/floor/plating,
/area/ruin/powered)
"rE" = (
/obj/effect/turf_decal/stripes/line{
	dir = 1
	},
/obj/effect/turf_decal/tile/neutral/opposingcorners{
	dir = 1
	},
/turf/open/floor/iron,
/area/ruin/powered)
"rJ" = (
/obj/structure/door_assembly/door_assembly_com,
/turf/open/floor/mineral/titanium/airless,
/area/template_noop)
"sH" = (
/obj/machinery/atmospherics/components/unary/shuttle/heater{
	dir = 1
	},
/obj/structure/window/reinforced/spawner/directional/south,
/obj/machinery/door/window/northleft,
/turf/open/floor/plating/airless,
/area/template_noop)
"sN" = (
/obj/effect/turf_decal/tile/neutral/opposingcorners{
	dir = 1
	},
/turf/open/floor/iron,
/area/ruin/powered)
"tv" = (
/obj/structure/sign/poster/random{
	pixel_x = 32
	},
/obj/effect/turf_decal/tile/neutral/opposingcorners,
/turf/open/floor/iron,
/area/ruin/powered)
"tP" = (
/obj/effect/turf_decal/stripes/line{
	dir = 8
	},
/obj/structure/grille,
/turf/open/floor/plating/airless,
/area/template_noop)
"ud" = (
/obj/machinery/door/airlock/external/glass,
/obj/effect/mapping_helpers/airlock/cyclelink_helper{
	dir = 1
	},
/turf/open/floor/plating,
/area/ruin/powered)
"vJ" = (
/obj/item/stock_parts/cell/crap,
/turf/open/floor/plating/airless,
/area/template_noop)
"wW" = (
/obj/effect/turf_decal/stripes/line{
	dir = 8
	},
/turf/open/floor/plating/airless,
/area/template_noop)
"yt" = (
/obj/effect/spawner/structure/window/reinforced,
/turf/open/floor/plating,
/area/ruin/powered)
"zv" = (
/obj/machinery/light/built{
	dir = 4
	},
/turf/open/floor/plating/airless,
/area/template_noop)
"Aa" = (
/turf/closed/wall,
/area/ruin/powered)
"Ah" = (
/turf/open/floor/plating,
/area/template_noop)
"Av" = (
/turf/open/floor/iron,
/area/ruin/powered)
"AE" = (
/obj/effect/turf_decal/stripes/line,
/turf/open/floor/plating/airless,
/area/template_noop)
"AI" = (
/obj/item/storage/toolbox/mechanical,
/turf/open/floor/plating/airless,
/area/template_noop)
"Cc" = (
/obj/effect/turf_decal/stripes/line{
	dir = 8
	},
/obj/structure/grille/broken,
/turf/open/floor/plating/airless,
/area/template_noop)
"CJ" = (
/obj/item/wallframe/apc,
/obj/item/electronics/apc,
/turf/open/floor/plating/airless,
/area/template_noop)
"CZ" = (
/obj/item/stack/sheet/glass/fifty,
/turf/open/floor/plating/airless,
/area/template_noop)
"Dg" = (
/obj/effect/turf_decal/stripes/line{
	dir = 9
	},
/turf/open/floor/plating/airless,
/area/template_noop)
"DC" = (
/obj/effect/turf_decal/stripes/line{
	dir = 8
	},
/turf/open/floor/iron,
/area/ruin/powered)
"Ew" = (
/obj/machinery/door/airlock/external/glass,
/obj/effect/mapping_helpers/airlock/cyclelink_helper{
	dir = 4
	},
/turf/open/floor/plating,
/area/ruin/powered)
"EO" = (
/obj/effect/turf_decal/stripes/line{
	dir = 10
	},
/turf/open/floor/plating/airless,
/area/template_noop)
"Fw" = (
/obj/machinery/door/airlock/external/glass,
/obj/effect/mapping_helpers/airlock/cyclelink_helper{
	dir = 4
	},
/turf/open/floor/plating,
/area/template_noop)
"Fx" = (
/obj/machinery/atmospherics/components/unary/shuttle/heater{
	dir = 1
	},
/obj/structure/window/reinforced/spawner/directional/south,
/obj/machinery/door/window/northright,
/turf/open/floor/plating/airless,
/area/template_noop)
"FW" = (
/obj/effect/turf_decal/stripes/line{
	dir = 4
	},
/turf/open/floor/plating/airless,
/area/template_noop)
"GG" = (
/obj/machinery/atmospherics/pipe/smart/manifold/purple/visible{
	dir = 1
	},
/turf/open/floor/plating/airless,
/area/template_noop)
"Hx" = (
/turf/template_noop,
/area/template_noop)
"HL" = (
/obj/structure/frame/computer,
/obj/effect/turf_decal/tile/blue/anticorner/contrasted{
	dir = 4
	},
/turf/open/floor/mineral/titanium/airless,
/area/template_noop)
"HW" = (
/obj/item/plant_tray/pot/random,
/obj/effect/turf_decal/stripes/line{
	dir = 8
	},
/turf/open/floor/iron,
/area/ruin/powered)
"Ky" = (
/obj/machinery/computer/shuttle_flight/custom_shuttle,
/obj/effect/turf_decal/tile/blue/half/contrasted{
	dir = 4
	},
/turf/open/floor/mineral/titanium/airless,
/area/template_noop)
"MD" = (
/obj/structure/girder,
/turf/open/floor/plating/airless,
/area/template_noop)
"NL" = (
/obj/structure/closet/emcloset,
/obj/effect/turf_decal/stripes/line{
	dir = 8
	},
/obj/effect/spawner/random/ruinloot/basic,
/turf/open/floor/iron,
/area/ruin/powered)
"OB" = (
/obj/effect/turf_decal/stripes/line{
	dir = 6
	},
/turf/open/floor/plating/airless,
/area/template_noop)
"PH" = (
/obj/effect/spawner/structure/window/reinforced/shuttle,
/turf/open/floor/plating,
/area/template_noop)
"PL" = (
/obj/machinery/atmospherics/pipe/smart/simple/purple/visible,
/turf/open/floor/plating/airless,
/area/template_noop)
"Qz" = (
/obj/structure/tank_dispenser/oxygen,
/turf/open/floor/plating/airless,
/area/template_noop)
"QN" = (
/obj/item/stack/sheet/iron/ten,
/turf/open/floor/plating/airless,
/area/template_noop)
"QR" = (
/obj/effect/abstract/doorway_marker{
	dir = 4
	},
/turf/open/floor/iron,
/area/ruin/powered)
"Sk" = (
/obj/item/electronics/airlock,
/turf/open/floor/plating/airless,
/area/template_noop)
"Sx" = (
/obj/machinery/atmospherics/components/unary/shuttle/heater{
	dir = 1
	},
/obj/structure/window/reinforced/spawner/directional/south,
/obj/structure/window/reinforced/spawner/directional/east,
/obj/structure/window/reinforced/spawner/directional/west,
/obj/machinery/door/window/northright,
/turf/open/floor/plating/airless,
/area/template_noop)
"SM" = (
/obj/machinery/door/airlock/external/glass,
/obj/effect/mapping_helpers/airlock/cyclelink_helper{
	dir = 8
	},
/turf/open/floor/plating,
/area/ruin/powered)
"Tj" = (
/turf/open/floor/plating/airless,
/area/template_noop)
"TV" = (
/obj/machinery/atmospherics/components/unary/plasma_refiner{
	dir = 4
	},
/turf/open/floor/plating/airless,
/area/template_noop)
"Wh" = (
/turf/closed/wall/mineral/titanium,
/area/template_noop)
"WT" = (
/obj/machinery/door/airlock/external/glass,
/obj/effect/mapping_helpers/airlock/cyclelink_helper{
	dir = 8
	},
/turf/open/floor/plating,
/area/template_noop)
"XY" = (
/obj/machinery/atmospherics/pipe/smart/simple/purple/visible{
	dir = 4
	},
/turf/open/floor/plating/airless,
/area/template_noop)
"Yy" = (
/obj/effect/turf_decal/tile/neutral/opposingcorners,
/turf/open/floor/iron,
/area/ruin/powered)
"YC" = (
/obj/machinery/vending/coffee,
/obj/effect/turf_decal/stripes/line{
	dir = 8
	},
/obj/effect/turf_decal/stripes/corner{
	dir = 4
	},
/turf/open/floor/iron,
/area/ruin/powered)
"Ze" = (
/turf/open/floor/plating,
/area/ruin/powered)

(1,1,1) = {"
Hx
Hx
Hx
Hx
Hx
Hx
es
es
es
es
es
Hx
Hx
Hx
Hx
Hx
Hx
Hx
Hx
Hx
Hx
"}
(2,1,1) = {"
Hx
Hx
Hx
Hx
Hx
Hx
es
Dg
wW
EO
es
es
es
Hx
Hx
Hx
Hx
Hx
Hx
Hx
Hx
"}
(3,1,1) = {"
Hx
Hx
Hx
Hx
Hx
es
es
iR
Tj
AE
wW
EO
es
es
es
es
Hx
Hx
Hx
Hx
Hx
"}
(4,1,1) = {"
Hx
Hx
Hx
es
es
es
Wh
tP
tP
Cc
Wh
Wh
Wh
Wh
Wh
es
es
es
Hx
Hx
Hx
"}
(5,1,1) = {"
Hx
Hx
es
es
Wh
Wh
Wh
Tj
Tj
Tj
Wh
Tj
Tj
Tj
Wh
Wh
Wh
es
es
Hx
Hx
"}
(6,1,1) = {"
Hx
Hx
es
Wh
Wh
mf
Wh
Tj
Tj
CZ
MD
Tj
Tj
Tj
Wh
TV
Wh
Wh
es
es
Hx
"}
(7,1,1) = {"
Hx
es
es
Wh
Tj
Tj
ig
Tj
zv
Tj
Tj
Tj
Tj
Tj
Wh
GG
PL
sH
ib
es
Hx
"}
(8,1,1) = {"
Hx
es
Wh
Wh
bf
Wh
Wh
Tj
Wh
Tj
Wh
Wh
Tj
Wh
Wh
XY
Tj
Wh
Wh
es
es
"}
(9,1,1) = {"
Hx
es
PH
bj
nu
nT
Wh
Tj
Tj
Tj
Tj
Tj
Tj
Qz
Wh
GG
PL
PL
sH
ib
es
"}
(10,1,1) = {"
Hx
es
PH
Ky
eR
nu
rJ
Tj
Tj
Tj
Tj
Tj
Tj
Tj
Sk
GG
PL
PL
Sx
ib
es
"}
(11,1,1) = {"
Hx
es
PH
HL
nu
nu
Wh
Tj
AI
Tj
Tj
Tj
Tj
Tj
Tj
GG
PL
PL
Fx
ib
es
"}
(12,1,1) = {"
Hx
es
Wh
Wh
ig
Wh
Wh
Wh
Tj
Wh
Wh
Wh
Tj
QN
Tj
XY
Tj
Wh
Wh
es
es
"}
(13,1,1) = {"
Hx
es
es
Wh
Tj
Tj
bf
CJ
Tj
Tj
Tj
Tj
Tj
Tj
MD
GG
PL
Fx
ib
es
Hx
"}
(14,1,1) = {"
Hx
Hx
es
Wh
Wh
Tj
Wh
vJ
Tj
Tj
Tj
Tj
Tj
Tj
MD
ob
Wh
Wh
es
es
Hx
"}
(15,1,1) = {"
Hx
Hx
es
es
Wh
Wh
Wh
Tj
Tj
Tj
Tj
Tj
Tj
Tj
Wh
Wh
Wh
es
es
Hx
Hx
"}
(16,1,1) = {"
Hx
Hx
Hx
es
es
es
Wh
Wh
Fw
Wh
Wh
Wh
Wh
Wh
Wh
es
es
es
Hx
Hx
Hx
"}
(17,1,1) = {"
Hx
Hx
Hx
Hx
Hx
es
es
Wh
Ah
Wh
FW
OB
es
es
es
es
Hx
Hx
Hx
Hx
Hx
"}
(18,1,1) = {"
Hx
Hx
Hx
Hx
Hx
Hx
es
Wh
WT
Wh
es
es
es
Hx
Hx
Hx
Hx
Hx
Hx
Hx
Hx
"}
(19,1,1) = {"
Hx
Hx
Hx
Hx
Hx
Hx
es
yt
Ew
yt
es
Hx
Hx
Hx
Hx
Hx
Hx
Hx
Hx
Hx
Hx
"}
(20,1,1) = {"
Hx
Hx
Hx
Aa
yt
yt
yt
yt
Ze
yt
yt
yt
yt
Aa
Hx
Hx
Hx
Hx
Hx
Hx
Hx
"}
(21,1,1) = {"
Hx
Hx
Hx
Aa
YC
lJ
NL
yt
SM
yt
DC
DC
HW
Aa
Aa
Aa
Aa
Aa
Aa
Aa
Aa
"}
(22,1,1) = {"
Hx
yt
yt
yt
rE
sN
sN
sN
sN
sN
sN
sN
sN
sN
sN
sN
sN
sN
sN
sN
sN
"}
(23,1,1) = {"
Hx
qm
Ze
ud
au
Av
Av
Av
Av
Av
Av
Av
Av
Av
Av
Av
Av
Av
Av
Av
aI
"}
(24,1,1) = {"
Hx
yt
yt
yt
jO
Yy
Yy
Yy
Yy
Yy
mz
Yy
Yy
Yy
tv
Yy
Yy
Yy
Yy
Yy
Yy
"}
(25,1,1) = {"
Hx
Hx
Hx
Aa
Aa
Aa
QR
Aa
Aa
Aa
Aa
Aa
Aa
Aa
Aa
Aa
Aa
Aa
QR
Aa
Aa
"}
