//MAP CONVERTED BY dmm2tgm.py THIS HEADER COMMENT PREVENTS RECONVERSION, DO NOT REMOVE
"ao" = (
/obj/effect/decal/cleanable/dirt/dust,
/obj/structure/chair/stool/directional/west,
/turf/open/floor/mineral/titanium,
/area/shuttle/exploration)
"aA" = (
/obj/machinery/atmospherics/components/unary/plasma_refiner{
	dir = 4
	},
/turf/open/floor/mineral/titanium,
/area/shuttle/exploration)
"bJ" = (
/obj/structure/cable/yellow{
	icon_state = "1-2"
	},
/obj/machinery/atmospherics/pipe/smart/manifold4w/supply/hidden/layer2,
/obj/machinery/atmospherics/pipe/smart/manifold4w/scrubbers/hidden/layer4,
/obj/effect/decal/cleanable/dirt/dust,
/turf/open/floor/mineral/titanium,
/area/shuttle/exploration)
"cb" = (
/obj/effect/turf_decal/stripes/line{
	dir = 1
	},
/obj/structure/cable/yellow{
	icon_state = "0-4"
	},
/obj/machinery/power/port_gen/pacman,
/obj/item/wrench,
/obj/effect/turf_decal/bot,
/turf/open/floor/mineral/titanium,
/area/shuttle/exploration)
"ch" = (
/obj/structure/lattice/catwalk,
/obj/machinery/atmospherics/components/unary/outlet_injector/on/layer4,
/turf/template_noop,
/area/shuttle/exploration)
"da" = (
/turf/closed/wall/mineral/titanium,
/area/shuttle/exploration)
"fm" = (
/obj/effect/turf_decal/stripes/line{
	dir = 1
	},
/obj/effect/decal/cleanable/dirt/dust,
/obj/machinery/atmospherics/components/binary/valve/layer2{
	dir = 8
	},
/obj/structure/extinguisher_cabinet/directional/north,
/turf/open/floor/mineral/titanium,
/area/shuttle/exploration)
"gN" = (
/obj/effect/decal/cleanable/dirt/dust,
/turf/open/floor/mineral/titanium,
/area/shuttle/exploration)
"hl" = (
/obj/machinery/shuttle/engine/plasma{
	dir = 1
	},
/turf/open/floor/plating,
/area/shuttle/exploration)
"ir" = (
/turf/open/floor/mineral/plastitanium,
/area/shuttle/exploration)
"jg" = (
/obj/structure/window/reinforced/survival_pod/spawner/directional/north,
/obj/machinery/atmospherics/components/unary/shuttle/heater{
	dir = 1
	},
/turf/open/floor/plating,
/area/shuttle/exploration)
"kP" = (
/obj/effect/mapping_helpers/airlock/cyclelink_helper{
	dir = 8
	},
/obj/machinery/door/airlock/external/glass,
/obj/structure/cable/yellow{
	icon_state = "4-8"
	},
/obj/effect/turf_decal/stripes{
	dir = 8
	},
/obj/machinery/atmospherics/pipe/smart/manifold4w/supply/hidden/layer2,
/obj/docking_port/mobile{
	dir = 8;
	dwidth = 6;
	height = 8;
	id = "exploration";
	name = "Exploration Shuttle";
	port_direction = 4;
	shuttle_object_type = /datum/orbital_object/shuttle/custom_shuttle;
	width = 16
	},
/turf/open/floor/mineral/plastitanium,
/area/shuttle/exploration)
"lA" = (
/obj/structure/cable/yellow{
	icon_state = "1-4"
	},
/obj/structure/cable/yellow,
/obj/machinery/power/shieldwallgen/atmos{
	dir = 1;
	id = "HolofieldExplo";
	anchored = 1
	},
/obj/machinery/door/poddoor/shutters{
	id = "exploshutters"
	},
/turf/open/floor/mineral/plastitanium,
/area/shuttle/exploration)
"mw" = (
/obj/structure/table,
/obj/machinery/recharger{
	pixel_y = 4;
	pixel_x = 6
	},
/obj/machinery/recharger{
	pixel_y = 4;
	pixel_x = -6
	},
/obj/machinery/atmospherics/pipe/smart/manifold4w/scrubbers/hidden/layer4,
/turf/open/floor/mineral/titanium,
/area/shuttle/exploration)
"oJ" = (
/obj/machinery/atmospherics/components/unary/vent_scrubber/on/layer4{
	dir = 8
	},
/obj/effect/decal/cleanable/dirt/dust,
/turf/open/floor/mineral/titanium,
/area/shuttle/exploration)
"oR" = (
/obj/structure/table,
/obj/item/trash/popcorn{
	pixel_y = 11
	},
/obj/item/paper/crumpled{
	default_raw_text = "<p>I bought you some food, but I ate it all before you came, sorry.</p><p>- RTH</p>";
	name = "scribbled note"
	},
/obj/item/trash/sosjerky{
	pixel_x = -6
	},
/obj/item/broken_bottle{
	pixel_x = 8;
	pixel_y = -2
	},
/obj/machinery/atmospherics/pipe/smart/manifold4w/scrubbers/hidden/layer4,
/turf/open/floor/mineral/titanium,
/area/shuttle/exploration)
"oZ" = (
/obj/structure/cable/yellow{
	icon_state = "2-8"
	},
/obj/machinery/holopad,
/obj/machinery/atmospherics/pipe/smart/manifold4w/scrubbers/hidden/layer4,
/obj/effect/decal/cleanable/dirt/dust,
/turf/open/floor/mineral/titanium,
/area/shuttle/exploration)
"pf" = (
/obj/structure/wall_closet/med/directional/east,
/obj/item/storage/firstaid,
/obj/item/reagent_containers/medspray/silver_sulf,
/obj/item/reagent_containers/medspray/synthflesh,
/turf/open/floor/mineral/titanium,
/area/shuttle/exploration)
"qP" = (
/obj/structure/cable/yellow{
	icon_state = "4-8"
	},
/obj/machinery/atmospherics/pipe/smart/manifold4w/supply/hidden/layer2,
/turf/open/floor/mineral/titanium,
/area/shuttle/exploration)
"rr" = (
/obj/effect/turf_decal/stripes/line{
	dir = 1
	},
/obj/structure/cable/yellow{
	icon_state = "4-8"
	},
/obj/machinery/power/apc/auto_name/directional/north,
/obj/structure/cable/yellow{
	icon_state = "0-8"
	},
/obj/effect/decal/cleanable/dirt/dust,
/obj/machinery/atmospherics/components/unary/vent_pump/on/layer2{
	dir = 4
	},
/turf/open/floor/mineral/titanium,
/area/shuttle/exploration)
"sE" = (
/obj/machinery/computer/shuttle_flight/custom_shuttle/exploration,
/turf/open/floor/mineral/plastitanium,
/area/shuttle/exploration)
"sT" = (
/obj/structure/chair/fancy/shuttle{
	dir = 1
	},
/turf/open/floor/mineral/titanium,
/area/shuttle/exploration)
"sW" = (
/obj/machinery/atmospherics/pipe/smart/simple/purple/visible{
	dir = 6
	},
/obj/effect/decal/cleanable/dirt/dust,
/turf/open/floor/mineral/titanium,
/area/shuttle/exploration)
"te" = (
/obj/effect/spawner/structure/window/reinforced/shuttle,
/turf/open/floor/plating,
/area/shuttle/exploration)
"tz" = (
/turf/closed/wall/mineral/plastitanium/nodiagonal,
/area/shuttle/exploration)
"vF" = (
/obj/effect/turf_decal/stripes/line,
/obj/effect/turf_decal/stripes/line{
	dir = 1
	},
/obj/machinery/door/airlock/shuttle/glass,
/turf/open/floor/mineral/plastitanium,
/area/shuttle/exploration)
"wb" = (
/obj/machinery/light{
	dir = 4
	},
/obj/machinery/computer/rdconsole/core{
	dir = 8
	},
/obj/effect/turf_decal/bot,
/turf/open/floor/mineral/titanium,
/area/shuttle/exploration)
"wq" = (
/obj/machinery/atmospherics/pipe/smart/manifold4w/scrubbers/hidden/layer4,
/obj/effect/decal/cleanable/dirt/dust,
/turf/open/floor/mineral/titanium,
/area/shuttle/exploration)
"wY" = (
/obj/structure/cable/yellow{
	icon_state = "1-2"
	},
/obj/structure/cable/yellow{
	icon_state = "2-4"
	},
/obj/machinery/atmospherics/pipe/smart/manifold4w/supply/hidden/layer2,
/obj/machinery/atmospherics/pipe/smart/manifold4w/scrubbers/hidden/layer4,
/obj/effect/decal/cleanable/dirt/dust,
/turf/open/floor/mineral/titanium,
/area/shuttle/exploration)
"xu" = (
/obj/machinery/door/airlock/external/glass,
/obj/machinery/atmospherics/pipe/smart/simple/scrubbers/hidden{
	dir = 4
	},
/obj/effect/mapping_helpers/airlock/cyclelink_helper{
	dir = 4
	},
/obj/structure/cable/yellow{
	icon_state = "4-8"
	},
/obj/effect/turf_decal/stripes{
	dir = 8
	},
/obj/machinery/atmospherics/pipe/smart/manifold4w/supply/hidden/layer2,
/turf/open/floor/mineral/plastitanium,
/area/shuttle/exploration)
"xB" = (
/obj/effect/spawner/structure/window/reinforced/shuttle,
/obj/machinery/atmospherics/pipe/smart/manifold4w/scrubbers/hidden/layer4,
/turf/open/floor/plating,
/area/shuttle/exploration)
"xU" = (
/obj/effect/turf_decal/stripes/line{
	dir = 1
	},
/obj/structure/cable/yellow{
	icon_state = "1-8"
	},
/obj/machinery/atmospherics/pipe/smart/manifold4w/supply/hidden/layer2,
/obj/machinery/atmospherics/pipe/smart/manifold4w/scrubbers/hidden/layer4,
/turf/open/floor/mineral/titanium,
/area/shuttle/exploration)
"yd" = (
/obj/structure/cable/yellow{
	icon_state = "4-8"
	},
/obj/effect/turf_decal/loading_area{
	dir = 4
	},
/obj/effect/turf_decal/stripes{
	dir = 8
	},
/obj/effect/decal/cleanable/dirt/dust,
/turf/open/floor/mineral/titanium,
/area/shuttle/exploration)
"yv" = (
/obj/machinery/atmospherics/components/unary/vent_pump/on/layer2{
	dir = 4
	},
/obj/effect/decal/cleanable/dirt/dust,
/turf/open/floor/mineral/titanium,
/area/shuttle/exploration)
"yT" = (
/obj/machinery/light{
	dir = 8
	},
/obj/machinery/gear_requisition/exploration,
/obj/machinery/button/door/directional/west{
	pixel_y = -6;
	pixel_x = -22;
	name = "Exploration Shutters";
	id = "exploshutters"
	},
/obj/machinery/button/shieldwallgen/directional/west{
	id = "HolofieldExplo";
	pixel_y = 3;
	color = "#00ff00";
	pixel_x = -22;
	name = "Holofield Generator"
	},
/turf/open/floor/mineral/titanium,
/area/shuttle/exploration)
"zb" = (
/obj/structure/cable/yellow{
	icon_state = "4-8"
	},
/obj/effect/decal/cleanable/dirt/dust,
/turf/open/floor/mineral/titanium,
/area/shuttle/exploration)
"Ax" = (
/turf/closed/wall/mineral/titanium/nodiagonal,
/area/shuttle/exploration)
"Bh" = (
/obj/effect/decal/cleanable/dirt/dust,
/obj/machinery/atmospherics/components/unary/vent_scrubber/on/layer4{
	dir = 1
	},
/turf/open/floor/mineral/titanium,
/area/shuttle/exploration)
"Cb" = (
/obj/structure/cable/yellow{
	icon_state = "1-2"
	},
/obj/machinery/door/airlock/shuttle/glass,
/obj/machinery/atmospherics/pipe/smart/manifold4w/supply/hidden/layer2,
/obj/machinery/atmospherics/pipe/smart/manifold4w/scrubbers/hidden/layer4,
/turf/open/floor/mineral/titanium,
/area/shuttle/exploration)
"Cg" = (
/obj/effect/decal/cleanable/dirt/dust,
/obj/machinery/camera/directional/east,
/turf/open/floor/mineral/titanium,
/area/shuttle/exploration)
"CB" = (
/obj/effect/turf_decal/stripes/line{
	dir = 1
	},
/obj/effect/decal/cleanable/dirt/dust,
/obj/structure/wall_closet/tool/directional/north,
/obj/item/storage/toolbox/mechanical,
/obj/item/multitool,
/obj/item/storage/belt/utility{
	pixel_y = -3
	},
/obj/machinery/atmospherics/pipe/layer_manifold/general/visible/layer2{
	dir = 8
	},
/turf/open/floor/mineral/titanium,
/area/shuttle/exploration)
"Ev" = (
/obj/structure/cable/yellow{
	icon_state = "0-2"
	},
/obj/machinery/power/shieldwallgen/atmos{
	id = "HolofieldExplo";
	anchored = 1
	},
/obj/machinery/door/poddoor/shutters{
	id = "exploshutters"
	},
/turf/open/floor/mineral/plastitanium,
/area/shuttle/exploration)
"Ey" = (
/obj/machinery/computer/arcade/orion_trail{
	dir = 4
	},
/obj/effect/turf_decal/bot_red,
/obj/item/toy/plush/runtime{
	pixel_y = 17
	},
/turf/open/floor/mineral/titanium,
/area/shuttle/exploration)
"Fl" = (
/obj/machinery/atmospherics/pipe/smart/manifold/purple/visible{
	dir = 1
	},
/obj/effect/turf_decal/delivery,
/obj/effect/decal/cleanable/dirt/dust,
/turf/open/floor/mineral/titanium,
/area/shuttle/exploration)
"Gx" = (
/obj/structure/chair/fancy/shuttle{
	dir = 1
	},
/obj/effect/decal/cleanable/dirt/dust,
/turf/open/floor/mineral/titanium,
/area/shuttle/exploration)
"GH" = (
/obj/machinery/atmospherics/pipe/smart/manifold/purple/visible{
	dir = 1
	},
/obj/effect/turf_decal/delivery,
/turf/open/floor/mineral/titanium,
/area/shuttle/exploration)
"Jp" = (
/obj/machinery/airalarm/directional/north{
	pixel_y = 23
	},
/obj/machinery/atmospherics/pipe/smart/manifold4w/scrubbers/hidden/layer4,
/obj/effect/decal/cleanable/dirt/dust,
/turf/open/floor/mineral/titanium,
/area/shuttle/exploration)
"Kh" = (
/obj/structure/chair/fancy/shuttle{
	dir = 4
	},
/obj/structure/wall_closet/science/directional/south,
/turf/open/floor/mineral/titanium,
/area/shuttle/exploration)
"KE" = (
/obj/structure/cable/yellow{
	icon_state = "4-8"
	},
/obj/structure/wall_closet/emergency/directional/north,
/obj/effect/turf_decal/stripes,
/obj/effect/turf_decal/stripes{
	dir = 1
	},
/obj/machinery/atmospherics/pipe/smart/manifold4w/supply/hidden/layer2,
/obj/machinery/light/small,
/obj/effect/decal/cleanable/dirt/dust,
/obj/item/clothing/suit/space/hardsuit/skinsuit,
/obj/item/tank/internals/emergency_oxygen,
/obj/item/clothing/mask/breath,
/obj/item/flashlight/oxycandle,
/obj/item/flashlight/oxycandle,
/turf/open/floor/mineral/plastitanium,
/area/shuttle/exploration)
"KZ" = (
/obj/structure/lattice,
/obj/machinery/atmospherics/pipe/smart/manifold4w/scrubbers/hidden/layer4,
/turf/template_noop,
/area/shuttle/exploration)
"Mx" = (
/obj/machinery/computer/objective,
/turf/open/floor/mineral/plastitanium,
/area/shuttle/exploration)
"ME" = (
/obj/machinery/atmospherics/components/unary/portables_connector/visible{
	dir = 8
	},
/obj/machinery/portable_atmospherics/canister/plasma,
/obj/effect/turf_decal/bot,
/obj/machinery/light/small{
	dir = 4
	},
/obj/effect/decal/cleanable/dirt/dust,
/turf/open/floor/mineral/titanium,
/area/shuttle/exploration)
"Nx" = (
/obj/structure/chair/fancy/shuttle{
	dir = 1
	},
/obj/item/radio/intercom{
	frequency = 1453;
	pixel_y = -30
	},
/obj/machinery/light/small{
	dir = 8
	},
/turf/open/floor/mineral/plastitanium,
/area/shuttle/exploration)
"Pg" = (
/obj/effect/turf_decal/loading_area{
	dir = 4
	},
/obj/effect/turf_decal/stripes{
	dir = 8
	},
/obj/effect/decal/cleanable/dirt/dust,
/turf/open/floor/mineral/titanium,
/area/shuttle/exploration)
"RQ" = (
/turf/template_noop,
/area/template_noop)
"Ue" = (
/obj/effect/turf_decal/bot,
/obj/effect/turf_decal/stripes/line{
	dir = 1
	},
/obj/effect/decal/cleanable/dirt/dust,
/obj/machinery/atmospherics/components/tank/air{
	dir = 8
	},
/turf/open/floor/mineral/titanium,
/area/shuttle/exploration)
"Vl" = (
/turf/closed/wall/mineral/plastitanium,
/area/shuttle/exploration)
"Vm" = (
/obj/structure/cable/yellow{
	icon_state = "1-2"
	},
/obj/machinery/atmospherics/pipe/smart/manifold4w/supply/hidden/layer2,
/obj/machinery/atmospherics/pipe/smart/manifold4w/scrubbers/hidden/layer4,
/obj/effect/decal/cleanable/dirt/dust,
/mob/living/simple_animal/turkey{
	atmos_requirements = list("min_oxy" = 0, "max_oxy" = 0, "min_tox" = 0, "max_tox" = 0, "min_co2" = 0, "max_co2" = 0, "min_n2" = 0, "max_n2" = 0);
	desc = "A veteran of Nanotrasen's Animal Experimentation Program that attempted to replicate the organic space suit that some hostile entities are known to have exhibited, Tom now serves Nanotrasen as the mascot of the Exploration Crew.";
	health = 200;
	maxHealth = 200;
	melee_damage = 5;
	minbodytemp = 2.7;
	name = "Tom"
	},
/turf/open/floor/mineral/titanium,
/area/shuttle/exploration)
"VC" = (
/obj/machinery/atmospherics/components/unary/portables_connector/visible{
	dir = 8
	},
/obj/machinery/portable_atmospherics/canister/plasma,
/obj/effect/turf_decal/bot,
/obj/effect/decal/cleanable/dirt/dust,
/turf/open/floor/mineral/titanium,
/area/shuttle/exploration)
"Wv" = (
/obj/machinery/atmospherics/pipe/smart/manifold4w/purple/visible,
/obj/effect/turf_decal/delivery,
/obj/effect/decal/cleanable/dirt/dust,
/turf/open/floor/mineral/titanium,
/area/shuttle/exploration)
"Xc" = (
/obj/machinery/telecomms/relay/preset/exploration,
/obj/effect/turf_decal/delivery,
/turf/open/floor/mineral/titanium,
/area/shuttle/exploration)
"XM" = (
/obj/structure/table,
/obj/machinery/light{
	dir = 4
	},
/obj/machinery/microwave{
	pixel_y = 9
	},
/obj/item/storage/box/donkpockets,
/obj/item/storage/box/donkpockets,
/turf/open/floor/mineral/titanium,
/area/shuttle/exploration)
"Zf" = (
/obj/structure/tank_dispenser/oxygen,
/obj/machinery/light{
	dir = 8
	},
/obj/effect/turf_decal/bot,
/turf/open/floor/mineral/titanium,
/area/shuttle/exploration)
"Zg" = (
/obj/structure/closet/crate,
/obj/item/circuitboard/computer/shuttle/exploration_shuttle,
/obj/item/stack/sheet/mineral/plasma/five,
/obj/item/pickaxe,
/obj/item/mining_scanner,
/obj/item/radio/headset/headset_exploration,
/obj/item/radio/headset/headset_exploration,
/obj/machinery/light/small{
	dir = 8
	},
/obj/effect/turf_decal/bot,
/turf/open/floor/mineral/titanium,
/area/shuttle/exploration)

(1,1,1) = {"
da
da
da
da
Ax
Ev
lA
Ax
Ax
Ax
Ax
Ax
Ax
tz
Vl
RQ
"}
(2,1,1) = {"
te
sE
Nx
da
yT
Pg
yd
Zf
Ey
Xc
Ax
cb
Zg
aA
tz
Vl
"}
(3,1,1) = {"
te
Mx
ir
vF
gN
gN
zb
yv
ao
gN
Ax
rr
gN
Fl
jg
hl
"}
(4,1,1) = {"
te
te
te
da
Jp
wq
oZ
Vm
bJ
wY
Cb
xU
Bh
GH
jg
hl
"}
(5,1,1) = {"
RQ
RQ
RQ
te
mw
Gx
gN
oJ
Cg
qP
Ax
fm
gN
GH
jg
hl
"}
(6,1,1) = {"
ch
KZ
KZ
xB
oR
Gx
gN
Kh
Ax
xu
Ax
CB
sW
Wv
jg
hl
"}
(7,1,1) = {"
RQ
RQ
RQ
te
XM
sT
pf
wb
Ax
KE
Ax
Ue
ME
VC
tz
Vl
"}
(8,1,1) = {"
RQ
RQ
RQ
da
da
te
Ax
Ax
Ax
kP
Ax
Ax
Ax
tz
Vl
RQ
"}
