//MAP CONVERTED BY dmm2tgm.py THIS HEADER COMMENT PREVENTS RECONVERSION, DO NOT REMOVE
"a" = (
/turf/closed/wall/mineral/titanium/nodiagonal,
/area/shuttle/turbolift/primary)
"l" = (
/obj/effect/decal/cleanable/dirt,
/turf/open/floor/plasteel,
/area/shuttle/turbolift/primary)
"o" = (
/obj/effect/turf_decal/stripes/line,
/obj/effect/decal/cleanable/dirt,
/turf/open/floor/plasteel,
/area/shuttle/turbolift/primary)
"v" = (
/obj/effect/turf_decal/stripes/line{
	dir = 6
	},
/obj/effect/decal/cleanable/dirt,
/turf/open/floor/plasteel,
/area/shuttle/turbolift/primary)
"A" = (
/obj/effect/turf_decal/stripes/line{
	dir = 10
	},
/obj/effect/decal/cleanable/dirt,
/turf/open/floor/plasteel,
/area/shuttle/turbolift/primary)
"C" = (
/obj/effect/turf_decal/stripes/line{
	dir = 5
	},
/obj/effect/decal/cleanable/dirt,
/turf/open/floor/plasteel,
/area/shuttle/turbolift/primary)
"G" = (
/obj/machinery/light/small{
	brightness = 3;
	dir = 8
	},
/obj/effect/turf_decal/stripes/line{
	dir = 8
	},
/obj/effect/decal/cleanable/dirt,
/turf/open/floor/plasteel,
/area/shuttle/turbolift/primary)
"J" = (
/obj/effect/turf_decal/stripes/line{
	dir = 1
	},
/obj/effect/decal/cleanable/dirt,
/turf/open/floor/plasteel,
/area/shuttle/turbolift/primary)
"P" = (
/obj/effect/turf_decal/stripes/closeup,
/obj/machinery/door/airlock/public/glass,
/obj/effect/decal/cleanable/dirt,
/turf/open/floor/plasteel,
/area/shuttle/turbolift/primary)
"T" = (
/obj/effect/turf_decal/stripes/line{
	dir = 9
	},
/obj/effect/decal/cleanable/dirt,
/turf/open/floor/plasteel,
/area/shuttle/turbolift/primary)
"U" = (
/obj/effect/turf_decal/stripes/closeup,
/obj/docking_port/mobile/turbolift{
	dwidth = 2;
	height = 4;
	id = "turbolift_primary";
	width = 5
	},
/obj/machinery/door/airlock/public/glass,
/obj/effect/decal/cleanable/dirt,
/turf/open/floor/plasteel,
/area/shuttle/turbolift/primary)
"X" = (
/obj/machinery/computer/turbolift{
	pixel_y = 5;
	shuttle_id = "turbolift_primary";
	pixel_x = 32
	},
/obj/effect/turf_decal/stripes/line{
	dir = 4
	},
/obj/effect/decal/cleanable/dirt,
/turf/open/floor/plasteel,
/area/shuttle/turbolift/primary)

(1,1,1) = {"
a
a
a
a
a
"}
(2,1,1) = {"
a
T
G
A
a
"}
(3,1,1) = {"
P
J
l
o
U
"}
(4,1,1) = {"
a
C
X
v
a
"}
(5,1,1) = {"
a
a
a
a
a
"}
