//MAP CONVERTED BY dmm2tgm.py THIS HEADER COMMENT PREVENTS RECONVERSION, DO NOT REMOVE
"ar" = (
/obj/machinery/atmospherics/pipe/simple/scrubbers/visible{
	dir = 6
	},
/turf/open/floor/engine,
/area/engine/engineering)
"aV" = (
/obj/machinery/atmospherics/pipe/simple/cyan/visible{
	dir = 4
	},
/obj/structure/cable{
	icon_state = "1-2"
	},
/turf/open/floor/engine,
/area/engine/engineering)
"bF" = (
/obj/machinery/atmospherics/components/unary/portables_connector/visible{
	dir = 1
	},
/obj/machinery/portable_atmospherics/canister/nitrogen,
/obj/effect/turf_decal/bot{
	dir = 1
	},
/turf/open/floor/plasteel,
/area/engine/engineering)
"bJ" = (
/obj/effect/turf_decal/bot{
	dir = 1
	},
/obj/machinery/atmospherics/components/unary/portables_connector/visible{
	dir = 1;
	name = "Connector Port (Air Supply)"
	},
/turf/open/floor/plasteel,
/area/engine/engineering)
"cl" = (
/obj/structure/cable{
	icon_state = "2-4"
	},
/turf/open/floor/engine,
/area/engine/engineering)
"dj" = (
/obj/machinery/atmospherics/pipe/simple/orange/visible,
/turf/open/floor/engine,
/area/engine/engineering)
"dE" = (
/obj/structure/window/plasma/reinforced{
	dir = 8
	},
/obj/machinery/power/rad_collector/anchored,
/obj/machinery/atmospherics/pipe/simple/general/visible{
	dir = 9
	},
/obj/structure/cable{
	icon_state = "0-4"
	},
/turf/open/floor/engine,
/area/engine/supermatter)
"ez" = (
/obj/machinery/atmospherics/pipe/simple/green/visible,
/obj/structure/cable{
	icon_state = "1-2"
	},
/turf/open/floor/engine,
/area/engine/engineering)
"fz" = (
/obj/effect/turf_decal/delivery,
/obj/machinery/atmospherics/pipe/simple/scrubbers/visible{
	dir = 6
	},
/turf/open/floor/plasteel,
/area/engine/engineering)
"gD" = (
/obj/machinery/atmospherics/components/trinary/filter/flipped/critical,
/turf/open/floor/engine,
/area/engine/engineering)
"hK" = (
/obj/machinery/atmospherics/pipe/simple/cyan/visible{
	dir = 1
	},
/turf/closed/wall/r_wall,
/area/engine/supermatter)
"ie" = (
/obj/structure/window/plasma/reinforced{
	dir = 8
	},
/obj/machinery/power/rad_collector/anchored,
/obj/machinery/atmospherics/pipe/manifold/general/visible{
	dir = 4
	},
/obj/structure/cable{
	icon_state = "0-4"
	},
/turf/open/floor/engine,
/area/engine/supermatter)
"iG" = (
/obj/machinery/atmospherics/pipe/manifold/cyan/visible{
	dir = 4
	},
/turf/open/floor/engine,
/area/engine/engineering)
"kw" = (
/obj/effect/turf_decal/stripes/line{
	dir = 4
	},
/turf/open/floor/engine,
/area/engine/engineering)
"la" = (
/obj/machinery/atmospherics/pipe/simple/green/visible,
/obj/structure/cable{
	icon_state = "1-4"
	},
/obj/structure/cable{
	icon_state = "1-2"
	},
/turf/open/floor/engine,
/area/engine/engineering)
"lJ" = (
/obj/machinery/atmospherics/components/trinary/filter/flipped/critical{
	filter_type = "n2"
	},
/turf/open/floor/engine,
/area/engine/engineering)
"lV" = (
/obj/machinery/atmospherics/components/binary/pump/on{
	name = "Waste to Filter";
	dir = 8
	},
/turf/open/floor/engine,
/area/engine/engineering)
"mk" = (
/obj/machinery/atmospherics/pipe/manifold/green/visible{
	dir = 1
	},
/turf/open/floor/engine,
/area/engine/engineering)
"mn" = (
/turf/closed/wall/r_wall,
/area/engine/supermatter)
"mU" = (
/obj/machinery/atmospherics/pipe/simple/green/visible{
	dir = 4
	},
/turf/open/floor/engine,
/area/engine/engineering)
"nt" = (
/obj/effect/spawner/structure/window/plasma/reinforced,
/turf/open/floor/plating,
/area/engine/supermatter)
"qv" = (
/obj/structure/cable{
	icon_state = "2-8"
	},
/turf/open/floor/engine,
/area/engine/engineering)
"rY" = (
/obj/machinery/atmospherics/pipe/simple/scrubbers/visible{
	dir = 4
	},
/obj/effect/turf_decal/stripes/line{
	dir = 4
	},
/turf/open/floor/engine,
/area/engine/engineering)
"sb" = (
/obj/structure/cable{
	icon_state = "1-2"
	},
/turf/open/floor/engine,
/area/engine/engineering)
"se" = (
/obj/structure/window/plasma/reinforced{
	dir = 4
	},
/obj/machinery/power/rad_collector/anchored,
/obj/machinery/atmospherics/pipe/manifold/general/visible{
	dir = 8
	},
/obj/structure/cable{
	icon_state = "0-8"
	},
/turf/open/floor/engine,
/area/engine/supermatter)
"vg" = (
/turf/open/floor/engine,
/area/engine/engineering)
"vo" = (
/obj/structure/window/plasma/reinforced{
	dir = 4
	},
/obj/machinery/power/rad_collector/anchored,
/obj/machinery/atmospherics/pipe/simple/general/visible{
	dir = 5
	},
/turf/open/floor/engine,
/area/engine/supermatter)
"vs" = (
/obj/machinery/atmospherics/pipe/simple/scrubbers/visible{
	dir = 4
	},
/turf/open/floor/engine,
/area/engine/engineering)
"yV" = (
/obj/machinery/atmospherics/pipe/simple/orange/visible{
	dir = 4
	},
/turf/open/floor/plasteel,
/area/engine/engineering)
"zL" = (
/obj/structure/cable{
	icon_state = "4-8"
	},
/turf/open/floor/engine,
/area/engine/engineering)
"Ab" = (
/obj/machinery/atmospherics/pipe/simple/scrubbers/visible{
	dir = 4
	},
/turf/open/floor/plasteel,
/area/engine/engineering)
"Aj" = (
/obj/machinery/atmospherics/components/unary/vent_pump/on{
	dir = 4
	},
/turf/open/floor/engine,
/area/engine/supermatter)
"Bf" = (
/obj/machinery/atmospherics/pipe/manifold/cyan/visible{
	dir = 1
	},
/turf/open/floor/engine,
/area/engine/engineering)
"Bg" = (
/obj/machinery/atmospherics/pipe/simple/orange/visible{
	dir = 6
	},
/obj/structure/cable{
	icon_state = "1-2"
	},
/turf/open/floor/engine,
/area/engine/engineering)
"Bo" = (
/obj/machinery/atmospherics/pipe/simple/scrubbers/visible{
	dir = 9
	},
/turf/open/floor/engine,
/area/engine/engineering)
"Br" = (
/obj/machinery/atmospherics/components/trinary/filter/flipped/critical{
	dir = 1
	},
/turf/open/floor/engine,
/area/engine/engineering)
"BW" = (
/obj/machinery/atmospherics/pipe/manifold/orange/visible{
	dir = 1
	},
/turf/open/floor/engine,
/area/engine/engineering)
"Cn" = (
/obj/machinery/atmospherics/pipe/simple/orange/visible{
	dir = 9
	},
/turf/open/floor/engine,
/area/engine/engineering)
"EG" = (
/obj/structure/cable{
	icon_state = "4-8"
	},
/obj/structure/cable{
	icon_state = "1-8"
	},
/turf/open/floor/engine,
/area/engine/engineering)
"EJ" = (
/obj/machinery/atmospherics/pipe/simple/orange/visible{
	dir = 6
	},
/turf/open/floor/engine,
/area/engine/engineering)
"Fg" = (
/obj/effect/turf_decal/stripes/line{
	dir = 8
	},
/turf/open/floor/engine,
/area/engine/engineering)
"FV" = (
/obj/machinery/atmospherics/pipe/simple/cyan/visible{
	dir = 6
	},
/turf/open/floor/engine,
/area/engine/engineering)
"GJ" = (
/obj/machinery/atmospherics/pipe/simple/general/visible{
	dir = 9
	},
/turf/closed/wall/r_wall,
/area/engine/supermatter)
"Hs" = (
/obj/machinery/atmospherics/components/binary/pump{
	dir = 1;
	name = "Gas to Filter"
	},
/turf/open/floor/engine,
/area/engine/supermatter)
"Jb" = (
/obj/machinery/atmospherics/components/binary/pump{
	name = "Gas to Chamber"
	},
/turf/open/floor/engine,
/area/engine/supermatter)
"JH" = (
/turf/open/floor/engine,
/area/engine/supermatter)
"KR" = (
/obj/effect/turf_decal/stripes/line{
	dir = 8
	},
/obj/machinery/atmospherics/pipe/simple/orange/visible{
	dir = 4
	},
/turf/open/floor/engine,
/area/engine/engineering)
"LD" = (
/obj/structure/cable{
	icon_state = "4-8"
	},
/turf/open/floor/engine,
/area/engine/supermatter)
"MD" = (
/obj/machinery/atmospherics/pipe/simple/general/visible{
	dir = 6
	},
/turf/closed/wall/r_wall,
/area/engine/supermatter)
"Nu" = (
/obj/effect/turf_decal/stripes/line{
	dir = 4
	},
/obj/machinery/atmospherics/pipe/simple/orange/visible{
	dir = 4
	},
/turf/open/floor/engine,
/area/engine/engineering)
"NT" = (
/obj/machinery/atmospherics/components/unary/vent_scrubber/on{
	dir = 8;
	level = 2
	},
/turf/open/floor/engine,
/area/engine/supermatter)
"Oo" = (
/obj/machinery/atmospherics/pipe/simple/green/visible{
	dir = 6
	},
/obj/structure/cable{
	icon_state = "1-2"
	},
/turf/open/floor/engine,
/area/engine/engineering)
"OW" = (
/obj/machinery/atmospherics/pipe/simple/orange/visible,
/obj/structure/cable{
	icon_state = "1-8"
	},
/turf/open/floor/engine,
/area/engine/engineering)
"OX" = (
/obj/machinery/atmospherics/pipe/simple/scrubbers/visible,
/obj/structure/cable{
	icon_state = "1-4"
	},
/turf/open/floor/engine,
/area/engine/engineering)
"RG" = (
/obj/machinery/power/supermatter_crystal/engine,
/turf/open/floor/engine,
/area/engine/supermatter)
"Si" = (
/obj/effect/turf_decal/delivery,
/obj/machinery/atmospherics/pipe/manifold/scrubbers/visible{
	dir = 4
	},
/turf/open/floor/plasteel,
/area/engine/engineering)
"Sr" = (
/obj/machinery/atmospherics/pipe/simple/general/visible{
	dir = 5
	},
/turf/closed/wall/r_wall,
/area/engine/supermatter)
"Ta" = (
/obj/machinery/atmospherics/components/binary/pump{
	name = "Cooling Loop bypass"
	},
/obj/structure/cable{
	icon_state = "1-4"
	},
/obj/structure/cable{
	icon_state = "1-2"
	},
/turf/open/floor/engine,
/area/engine/engineering)
"Te" = (
/obj/machinery/atmospherics/pipe/simple/general/visible{
	dir = 10
	},
/turf/closed/wall/r_wall,
/area/engine/supermatter)
"Tm" = (
/obj/machinery/atmospherics/pipe/simple/orange/visible,
/obj/structure/cable{
	icon_state = "1-2"
	},
/turf/open/floor/engine,
/area/engine/engineering)
"Tr" = (
/obj/machinery/atmospherics/pipe/simple/scrubbers/visible{
	dir = 4
	},
/obj/effect/turf_decal/stripes/line{
	dir = 8
	},
/turf/open/floor/engine,
/area/engine/engineering)
"TR" = (
/obj/machinery/atmospherics/pipe/simple/orange/visible{
	dir = 4
	},
/turf/open/floor/engine,
/area/engine/engineering)
"Ua" = (
/obj/machinery/atmospherics/pipe/simple/cyan/visible{
	dir = 4
	},
/turf/open/floor/engine,
/area/engine/engineering)
"UF" = (
/turf/open/floor/plasteel,
/area/engine/engineering)
"UP" = (
/obj/structure/cable{
	icon_state = "4-8"
	},
/turf/open/floor/plating,
/area/engine/supermatter)
"Vv" = (
/obj/machinery/atmospherics/components/binary/pump{
	dir = 1
	},
/obj/effect/turf_decal/delivery,
/turf/open/floor/plasteel,
/area/engine/engineering)
"Ws" = (
/obj/machinery/atmospherics/pipe/simple/orange/visible,
/obj/structure/cable{
	icon_state = "1-8"
	},
/obj/structure/cable{
	icon_state = "1-2"
	},
/turf/open/floor/engine,
/area/engine/engineering)
"XU" = (
/obj/machinery/atmospherics/pipe/simple/scrubbers/visible,
/turf/open/floor/engine,
/area/engine/engineering)
"YY" = (
/obj/machinery/atmospherics/pipe/simple/scrubbers/visible{
	dir = 5
	},
/turf/open/floor/engine,
/area/engine/engineering)

(1,1,1) = {"
vg
vg
vg
vg
vg
vg
vg
vg
vg
vg
vg
vg
vg
"}
(2,1,1) = {"
cl
sb
Oo
ez
ez
ez
la
Ta
OX
XU
XU
YY
vg
"}
(3,1,1) = {"
EG
vg
mU
fz
bJ
mn
UP
UP
UP
mn
EJ
lJ
vg
"}
(4,1,1) = {"
zL
vg
Br
Si
bJ
mn
LD
LD
LD
mn
TR
vs
vg
"}
(5,1,1) = {"
zL
vg
mU
mn
mn
MD
se
se
vo
mn
BW
gD
vg
"}
(6,1,1) = {"
zL
vg
mk
mn
Hs
GJ
NT
NT
NT
mn
Nu
rY
kw
"}
(7,1,1) = {"
EG
vg
lV
JH
JH
JH
JH
RG
JH
nt
yV
Ab
UF
"}
(8,1,1) = {"
zL
vg
Bf
hK
Jb
Sr
Aj
Aj
Aj
mn
KR
Tr
Fg
"}
(9,1,1) = {"
zL
vg
Ua
mn
mn
Te
ie
ie
dE
mn
BW
gD
vg
"}
(10,1,1) = {"
zL
vg
Bf
Vv
bF
mn
LD
LD
LD
mn
TR
vs
vg
"}
(11,1,1) = {"
EG
FV
iG
Vv
bF
mn
UP
UP
UP
mn
BW
gD
vg
"}
(12,1,1) = {"
qv
aV
Bg
Tm
Tm
Tm
Ws
Ws
OW
dj
Cn
vs
vg
"}
(13,1,1) = {"
vg
Ua
TR
ar
XU
XU
XU
XU
XU
XU
XU
Bo
vg
"}
