//MAP CONVERTED BY dmm2tgm.py THIS HEADER COMMENT PREVENTS RECONVERSION, DO NOT REMOVE
"a" = (
/turf/closed/wall/mineral/wood,
/area/space)
"m" = (
/mob/living/simple_animal/hostile/netherworld/migo{
	health = 800;
	name = "thing"
	},
/turf/open/floor/carpet,
/area/space)
"p" = (
/turf/open/floor/carpet,
/area/space)

(1,1,1) = {"
a
a
a
a
a
a
a
a
a
a
a
a
a
a
a
a
a
a
a
a
a
a
a
a
a
a
a
a
a
a
a
a
"}
(2,1,1) = {"
a
p
p
p
p
p
p
p
p
p
p
p
p
p
p
p
p
p
p
p
p
p
p
p
p
p
p
p
p
p
p
a
"}
(3,1,1) = {"
a
p
p
p
p
p
p
p
p
p
p
p
p
p
p
p
p
p
p
p
p
p
p
p
p
p
p
p
p
p
p
a
"}
(4,1,1) = {"
a
p
p
a
a
a
p
p
a
a
a
p
p
a
a
a
a
a
a
p
p
a
a
a
p
p
a
a
a
p
p
a
"}
(5,1,1) = {"
a
p
p
a
a
a
p
p
a
a
a
p
p
a
a
a
a
a
a
p
p
a
a
a
p
p
a
a
a
p
p
a
"}
(6,1,1) = {"
a
p
p
a
a
a
p
p
a
a
a
p
p
a
a
a
a
a
a
p
p
a
a
a
p
p
a
a
a
p
p
a
"}
(7,1,1) = {"
a
p
p
p
p
p
p
p
p
p
p
p
p
a
a
a
a
a
a
p
p
p
p
p
p
p
p
p
p
p
p
a
"}
(8,1,1) = {"
a
p
p
p
p
p
p
p
p
p
p
p
p
a
a
a
a
a
a
p
p
p
p
p
p
p
p
p
p
p
p
a
"}
(9,1,1) = {"
a
p
p
a
a
a
p
p
a
a
a
p
p
a
a
a
a
a
a
p
p
a
a
a
p
p
a
a
a
p
p
a
"}
(10,1,1) = {"
a
p
p
a
a
a
p
p
a
a
a
p
p
p
p
p
p
p
p
p
p
a
a
a
p
p
a
a
a
p
p
a
"}
(11,1,1) = {"
a
p
p
a
a
a
p
p
a
a
a
p
p
p
p
p
p
p
p
p
p
a
a
a
p
p
a
a
a
p
p
a
"}
(12,1,1) = {"
a
p
p
p
p
p
p
p
p
p
p
p
p
p
p
p
p
p
p
p
p
p
p
p
p
p
p
p
p
p
p
a
"}
(13,1,1) = {"
a
p
p
p
p
p
p
p
p
p
p
p
p
p
p
p
p
p
p
p
p
p
p
p
p
p
p
p
p
p
p
a
"}
(14,1,1) = {"
a
p
p
a
a
a
a
a
a
p
p
p
p
a
a
a
a
a
a
p
p
p
p
a
a
a
a
a
a
p
p
a
"}
(15,1,1) = {"
a
p
p
a
a
a
a
a
a
p
p
p
p
a
a
a
a
a
a
p
p
p
p
a
a
a
a
a
a
p
p
a
"}
(16,1,1) = {"
a
p
p
a
a
a
a
a
a
p
p
p
p
a
a
a
a
a
a
p
p
p
p
a
a
a
a
a
a
p
p
a
"}
(17,1,1) = {"
a
p
p
a
a
a
a
a
a
p
p
p
p
a
a
a
a
a
a
p
p
p
p
a
a
a
a
a
a
p
p
a
"}
(18,1,1) = {"
a
p
p
a
a
a
a
a
a
p
p
p
p
a
a
a
a
a
a
p
p
p
p
a
a
a
a
a
a
p
p
a
"}
(19,1,1) = {"
a
p
p
a
a
a
a
a
a
p
p
p
p
a
a
a
a
a
a
p
p
p
p
a
a
a
a
a
a
p
p
a
"}
(20,1,1) = {"
a
p
p
p
p
p
p
p
p
p
p
p
p
p
p
p
p
p
p
p
p
p
p
p
p
p
p
p
p
p
p
a
"}
(21,1,1) = {"
a
p
p
p
p
p
p
p
p
p
p
p
p
p
p
p
p
p
p
p
p
p
p
p
p
p
p
p
p
p
p
a
"}
(22,1,1) = {"
a
p
p
a
a
a
p
p
a
a
a
p
p
p
p
p
p
p
p
p
p
a
a
a
p
p
a
a
a
p
p
a
"}
(23,1,1) = {"
a
p
p
a
a
a
p
p
a
a
a
p
p
p
p
p
p
p
p
p
p
a
a
a
p
p
a
a
a
p
p
a
"}
(24,1,1) = {"
a
p
p
a
a
a
p
p
a
a
a
p
p
a
a
a
a
a
a
p
p
a
a
a
p
p
a
a
a
p
p
a
"}
(25,1,1) = {"
a
p
p
p
p
m
p
p
p
p
p
p
p
a
a
a
a
a
a
p
p
p
p
p
p
p
p
p
p
p
p
a
"}
(26,1,1) = {"
a
p
p
p
p
p
p
p
p
p
p
p
p
a
a
a
a
a
a
p
p
p
p
p
p
p
p
p
p
p
p
a
"}
(27,1,1) = {"
a
p
p
a
a
a
p
p
a
a
a
p
p
a
a
a
a
a
a
p
p
a
a
a
p
p
a
a
a
p
p
a
"}
(28,1,1) = {"
a
p
p
a
a
a
p
p
a
a
a
p
p
a
a
a
a
a
a
p
p
a
a
a
p
p
a
a
a
p
p
a
"}
(29,1,1) = {"
a
p
p
a
a
a
p
p
a
a
a
p
p
a
a
a
a
a
a
p
p
a
a
a
p
p
a
a
a
p
p
a
"}
(30,1,1) = {"
a
p
p
p
p
p
p
p
p
p
p
p
p
p
p
p
p
p
p
p
p
p
p
p
p
p
p
p
p
p
p
a
"}
(31,1,1) = {"
a
p
p
p
p
p
p
p
p
p
p
p
p
p
p
p
p
p
p
p
p
p
p
p
p
p
p
p
p
p
p
a
"}
(32,1,1) = {"
a
a
a
a
a
a
a
a
a
a
a
a
a
a
a
a
a
a
a
a
a
a
a
a
a
a
a
a
a
a
a
a
"}
