//MAP CONVERTED BY dmm2tgm.py THIS HEADER COMMENT PREVENTS RECONVERSION, DO NOT REMOVE
"a" = (
/obj/machinery/atmospherics/pipe/simple/general/visible{
	dir = 5
	},
/turf/open/floor/plating,
/area/shuttle/arrival)
"b" = (
/obj/structure/table,
/obj/item/clothing/head/soft/grey{
	pixel_x = -2;
	pixel_y = 3
	},
/turf/open/floor/mineral/titanium/blue,
/area/shuttle/arrival)
"f" = (
/obj/structure/table,
/obj/item/radio{
	desc = "An old handheld radio. You could use it, if you really wanted to.";
	icon_state = "radio";
	name = "old radio"
	},
/turf/open/floor/mineral/titanium/blue,
/area/shuttle/arrival)
"g" = (
/obj/structure/table,
/obj/item/phone,
/turf/open/floor/mineral/titanium/blue,
/area/shuttle/arrival)
"h" = (
/obj/machinery/light,
/turf/open/floor/mineral/titanium/blue,
/area/shuttle/arrival)
"i" = (
/obj/machinery/atmospherics/pipe/manifold/general/visible{
	dir = 8
	},
/turf/open/floor/plating,
/area/shuttle/arrival)
"j" = (
/obj/structure/chair/fancy/shuttle,
/obj/machinery/light{
	dir = 4
	},
/turf/open/floor/mineral/titanium/blue,
/area/shuttle/arrival)
"k" = (
/obj/structure/closet/emcloset,
/obj/machinery/light{
	dir = 8
	},
/turf/open/floor/mineral/titanium/blue,
/area/shuttle/arrival)
"m" = (
/obj/structure/closet/wardrobe/grey,
/obj/machinery/light,
/turf/open/floor/mineral/titanium/blue,
/area/shuttle/arrival)
"p" = (
/obj/machinery/atmospherics/components/unary/portables_connector/visible{
	dir = 4
	},
/turf/open/floor/plating,
/area/shuttle/arrival)
"r" = (
/obj/machinery/computer/arcade,
/turf/open/floor/mineral/titanium/blue,
/area/shuttle/arrival)
"s" = (
/obj/machinery/door/airlock/maintenance{
	req_one_access_txt = "12;27"
	},
/turf/open/floor/plating,
/area/shuttle/arrival)
"t" = (
/turf/open/floor/mineral/titanium/blue,
/area/shuttle/arrival)
"u" = (
/obj/structure/shuttle/engine/propulsion/burst/right{
	dir = 4
	},
/turf/open/floor/plating,
/area/shuttle/arrival)
"v" = (
/obj/structure/table,
/obj/item/storage/firstaid/regular,
/turf/open/floor/mineral/titanium/blue,
/area/shuttle/arrival)
"w" = (
/obj/machinery/door/airlock/titanium{
	name = "Arrivals Shuttle Airlock"
	},
/turf/open/floor/mineral/titanium/blue,
/area/shuttle/arrival)
"x" = (
/obj/structure/table,
/obj/item/paper_bin,
/obj/item/pen{
	pixel_x = -4;
	pixel_y = 4
	},
/obj/item/pen{
	pixel_x = -4;
	pixel_y = 4
	},
/turf/open/floor/mineral/titanium/blue,
/area/shuttle/arrival)
"z" = (
/obj/machinery/atmospherics/pipe/manifold/general/visible{
	dir = 1
	},
/turf/open/floor/plating,
/area/shuttle/arrival)
"A" = (
/obj/machinery/door/airlock/titanium{
	name = "Arrivals Shuttle Airlock"
	},
/turf/open/floor/plating,
/area/shuttle/arrival)
"C" = (
/obj/structure/table,
/obj/effect/spawner/lootdrop/maintenance,
/turf/open/floor/mineral/titanium/blue,
/area/shuttle/arrival)
"D" = (
/turf/template_noop,
/area/shuttle/arrival)
"E" = (
/obj/structure/closet/emcloset,
/turf/open/floor/mineral/titanium/blue,
/area/shuttle/arrival)
"F" = (
/obj/machinery/light{
	dir = 1
	},
/turf/open/floor/mineral/titanium/blue,
/area/shuttle/arrival)
"G" = (
/obj/machinery/light{
	dir = 4
	},
/turf/open/floor/mineral/titanium/blue,
/area/shuttle/arrival)
"H" = (
/obj/structure/closet/wardrobe/green,
/turf/open/floor/mineral/titanium/blue,
/area/shuttle/arrival)
"J" = (
/obj/structure/closet/wardrobe/mixed,
/turf/open/floor/mineral/titanium/blue,
/area/shuttle/arrival)
"K" = (
/obj/structure/closet/wardrobe/black,
/turf/open/floor/mineral/titanium/blue,
/area/shuttle/arrival)
"P" = (
/obj/structure/table,
/obj/item/paicard,
/turf/open/floor/mineral/titanium/blue,
/area/shuttle/arrival)
"Q" = (
/obj/structure/shuttle/engine/heater{
	dir = 4
	},
/obj/structure/window/reinforced{
	dir = 8
	},
/turf/open/floor/plating,
/area/shuttle/arrival)
"R" = (
/obj/structure/chair/fancy/shuttle{
	dir = 8
	},
/turf/open/floor/mineral/titanium,
/area/shuttle/arrival)
"S" = (
/turf/open/floor/mineral/titanium,
/area/shuttle/arrival)
"T" = (
/obj/structure/window/shuttle,
/obj/structure/grille,
/turf/open/floor/plating,
/area/shuttle/arrival)
"U" = (
/obj/structure/shuttle/engine/propulsion/burst/right{
	dir = 4
	},
/obj/docking_port/mobile/arrivals,
/turf/open/floor/plating,
/area/shuttle/arrival)
"V" = (
/obj/structure/chair/fancy/shuttle,
/turf/open/floor/mineral/titanium/blue,
/area/shuttle/arrival)
"W" = (
/turf/open/floor/plating,
/area/shuttle/arrival)
"X" = (
/turf/closed/wall/mineral/titanium,
/area/shuttle/arrival)
"Y" = (
/obj/machinery/light/small{
	brightness = 3;
	dir = 8
	},
/turf/open/floor/plating,
/area/shuttle/arrival)
"Z" = (
/obj/structure/chair/fancy/shuttle{
	dir = 1
	},
/turf/open/floor/mineral/titanium/blue,
/area/shuttle/arrival)

(1,1,1) = {"
D
D
X
T
T
T
X
D
D
"}
(2,1,1) = {"
D
D
T
V
t
Z
T
D
D
"}
(3,1,1) = {"
D
D
T
V
S
Z
T
D
D
"}
(4,1,1) = {"
D
D
T
j
t
Z
T
D
D
"}
(5,1,1) = {"
D
D
X
X
w
X
X
D
D
"}
(6,1,1) = {"
D
X
X
k
t
t
X
X
D
"}
(7,1,1) = {"
D
X
v
t
S
t
P
X
D
"}
(8,1,1) = {"
D
T
r
R
R
R
H
T
D
"}
(9,1,1) = {"
D
T
t
S
S
S
K
T
D
"}
(10,1,1) = {"
D
T
t
R
R
R
J
T
D
"}
(11,1,1) = {"
X
X
F
S
S
S
m
X
X
"}
(12,1,1) = {"
T
g
t
R
R
R
t
b
T
"}
(13,1,1) = {"
X
t
S
S
S
S
S
t
X
"}
(14,1,1) = {"
A
t
S
R
R
R
S
t
A
"}
(15,1,1) = {"
X
t
S
S
S
S
S
t
X
"}
(16,1,1) = {"
T
x
t
R
R
R
t
C
T
"}
(17,1,1) = {"
X
X
F
S
S
S
h
X
X
"}
(18,1,1) = {"
D
T
r
R
R
R
t
T
D
"}
(19,1,1) = {"
D
T
v
t
S
t
f
T
D
"}
(20,1,1) = {"
D
X
X
t
S
t
X
X
D
"}
(21,1,1) = {"
D
D
X
E
t
G
X
D
D
"}
(22,1,1) = {"
D
D
X
X
s
X
X
D
D
"}
(23,1,1) = {"
D
D
X
p
W
Y
X
D
D
"}
(24,1,1) = {"
D
D
X
z
i
a
X
D
D
"}
(25,1,1) = {"
D
D
X
Q
Q
Q
X
D
D
"}
(26,1,1) = {"
D
D
X
u
U
u
X
D
D
"}
