//MAP CONVERTED BY dmm2tgm.py THIS HEADER COMMENT PREVENTS RECONVERSION, DO NOT REMOVE
"bx" = (
/obj/machinery/door/airlock/titanium{
	name = "Arrivals Shuttle Airlock"
	},
/obj/structure/fans/tiny,
/turf/open/floor/plating,
/area/shuttle/arrival)
"eq" = (
/obj/structure/chair/fancy/shuttle,
/obj/effect/turf_decal/stripes/line,
/turf/open/floor/mineral/plastitanium,
/area/shuttle/arrival)
"fr" = (
/obj/structure/chair/fancy/shuttle{
	dir = 8
	},
/obj/effect/turf_decal/stripes/line{
	dir = 8
	},
/turf/open/floor/mineral/plastitanium,
/area/shuttle/arrival)
"hD" = (
/obj/structure/chair/fancy/shuttle{
	dir = 4
	},
/obj/effect/turf_decal/stripes/line{
	dir = 4
	},
/turf/open/floor/mineral/plastitanium,
/area/shuttle/arrival)
"jC" = (
/obj/structure/lattice,
/turf/template_noop,
/area/template_noop)
"jX" = (
/obj/effect/turf_decal/stripes/end{
	dir = 4
	},
/turf/open/floor/mineral/plastitanium,
/area/shuttle/arrival)
"kd" = (
/obj/structure/lattice/catwalk/over,
/obj/structure/closet/wardrobe/orange,
/turf/open/floor/plating,
/area/shuttle/arrival)
"oR" = (
/obj/structure/lattice/catwalk/over,
/obj/structure/closet/emcloset,
/turf/open/floor/plating,
/area/shuttle/arrival)
"rx" = (
/obj/structure/lattice/catwalk/over,
/obj/structure/closet/firecloset,
/turf/open/floor/plating,
/area/shuttle/arrival)
"ts" = (
/obj/structure/lattice/catwalk/over,
/obj/structure/closet/wardrobe/black,
/obj/machinery/light{
	dir = 1
	},
/turf/open/floor/plating,
/area/shuttle/arrival)
"um" = (
/obj/docking_port/mobile/arrivals,
/turf/closed/wall/mineral/titanium,
/area/shuttle/arrival)
"uK" = (
/obj/structure/lattice/catwalk/over,
/obj/structure/closet/wardrobe/green,
/turf/open/floor/plating,
/area/shuttle/arrival)
"vh" = (
/obj/effect/turf_decal/stripes/corner{
	dir = 4
	},
/obj/effect/turf_decal/stripes/line{
	dir = 10
	},
/turf/open/floor/mineral/plastitanium,
/area/shuttle/arrival)
"xm" = (
/obj/effect/turf_decal/stripes/corner{
	dir = 1
	},
/obj/effect/turf_decal/stripes/line{
	dir = 6
	},
/turf/open/floor/mineral/plastitanium,
/area/shuttle/arrival)
"zF" = (
/obj/effect/turf_decal/stripes/corner,
/obj/effect/turf_decal/stripes/line{
	dir = 9
	},
/turf/open/floor/mineral/plastitanium,
/area/shuttle/arrival)
"zS" = (
/obj/structure/lattice/catwalk/over,
/obj/structure/closet/wardrobe/mixed,
/turf/open/floor/plating,
/area/shuttle/arrival)
"AX" = (
/obj/effect/turf_decal/stripes/corner{
	dir = 8
	},
/obj/effect/turf_decal/stripes/line{
	dir = 5
	},
/turf/open/floor/mineral/plastitanium,
/area/shuttle/arrival)
"DY" = (
/obj/effect/turf_decal/stripes/line{
	dir = 6
	},
/turf/open/floor/mineral/plastitanium,
/area/shuttle/arrival)
"Ek" = (
/obj/effect/turf_decal/stripes/end{
	dir = 8
	},
/turf/open/floor/mineral/plastitanium,
/area/shuttle/arrival)
"Fj" = (
/obj/structure/lattice/catwalk/over,
/turf/open/floor/plating,
/area/shuttle/arrival)
"Jt" = (
/obj/structure/chair/fancy/shuttle{
	dir = 1
	},
/obj/effect/turf_decal/stripes/line{
	dir = 1
	},
/turf/open/floor/mineral/plastitanium,
/area/shuttle/arrival)
"Mx" = (
/obj/effect/turf_decal/stripes/line{
	dir = 10
	},
/turf/open/floor/mineral/plastitanium,
/area/shuttle/arrival)
"My" = (
/obj/effect/turf_decal/stripes/line{
	dir = 5
	},
/turf/open/floor/mineral/plastitanium,
/area/shuttle/arrival)
"OU" = (
/obj/structure/chair/fancy/shuttle{
	dir = 8
	},
/obj/effect/turf_decal/stripes/closeup{
	dir = 1
	},
/turf/open/floor/mineral/plastitanium,
/area/shuttle/arrival)
"Qn" = (
/obj/structure/lattice,
/obj/item/stack/marker_beacon{
	anchored = 1;
	icon_state = "markerburgundy-on";
	light_color = "#FA644B";
	light_power = 3;
	light_range = 2;
	name = "landing marker";
	picked_color = "Burgundy"
	},
/turf/template_noop,
/area/template_noop)
"SU" = (
/obj/effect/turf_decal/stripes/closeup,
/turf/open/floor/mineral/plastitanium,
/area/shuttle/arrival)
"Tm" = (
/obj/structure/lattice/catwalk/over,
/obj/structure/table,
/obj/item/paicard,
/obj/machinery/light{
	dir = 4;
	light_color = "#e8eaff"
	},
/turf/open/floor/plating,
/area/shuttle/arrival)
"TY" = (
/obj/structure/lattice/catwalk/over,
/obj/structure/closet/emcloset,
/obj/machinery/light{
	dir = 8
	},
/turf/open/floor/plating,
/area/shuttle/arrival)
"Uv" = (
/turf/closed/wall/mineral/titanium,
/area/shuttle/arrival)
"Va" = (
/obj/structure/lattice/catwalk/over,
/obj/structure/table,
/obj/item/storage/firstaid/regular,
/turf/open/floor/plating,
/area/shuttle/arrival)
"Wd" = (
/obj/structure/chair/fancy/shuttle,
/obj/effect/turf_decal/stripes/closeup,
/turf/open/floor/mineral/plastitanium,
/area/shuttle/arrival)
"WP" = (
/obj/effect/turf_decal/stripes/closeup{
	dir = 1
	},
/turf/open/floor/mineral/plastitanium,
/area/shuttle/arrival)
"XM" = (
/obj/effect/turf_decal/stripes/line{
	dir = 9
	},
/turf/open/floor/mineral/plastitanium,
/area/shuttle/arrival)
"Yt" = (
/obj/structure/chair/fancy/shuttle{
	dir = 4
	},
/obj/effect/turf_decal/stripes/closeup{
	dir = 1
	},
/turf/open/floor/mineral/plastitanium,
/area/shuttle/arrival)

(1,1,1) = {"
Qn
jC
jC
Uv
Uv
Uv
Uv
Uv
jC
jC
Qn
"}
(2,1,1) = {"
jC
Uv
Uv
Uv
rx
TY
oR
Uv
Uv
Uv
jC
"}
(3,1,1) = {"
jC
Uv
zF
WP
Yt
Yt
Yt
WP
vh
Uv
jC
"}
(4,1,1) = {"
Uv
Uv
SU
Fj
Fj
Fj
Fj
Fj
SU
Uv
Uv
"}
(5,1,1) = {"
Uv
uK
Wd
Fj
XM
fr
Mx
Fj
jX
Fj
Uv
"}
(6,1,1) = {"
Uv
ts
Wd
Fj
Jt
Uv
eq
Fj
Fj
Fj
bx
"}
(7,1,1) = {"
Uv
kd
Wd
Fj
My
hD
DY
Fj
Ek
Fj
Uv
"}
(8,1,1) = {"
Uv
Uv
SU
Fj
Fj
Fj
Fj
Fj
SU
Uv
Uv
"}
(9,1,1) = {"
jC
Uv
AX
WP
OU
OU
OU
WP
xm
Uv
jC
"}
(10,1,1) = {"
jC
Uv
Uv
Uv
zS
Tm
Va
Uv
Uv
Uv
jC
"}
(11,1,1) = {"
Qn
jC
jC
Uv
Uv
um
Uv
Uv
jC
jC
Qn
"}
