//MAP CONVERTED BY dmm2tgm.py THIS HEADER COMMENT PREVENTS RECONVERSION, DO NOT REMOVE
"af" = (
/obj/structure/chair/fancy/shuttle,
/turf/open/floor/mineral/plastitanium,
/area/shuttle/arrival)
"bd" = (
/obj/effect/turf_decal/stripes/closeup{
	dir = 1
	},
/obj/machinery/door/airlock/grunge,
/turf/open/floor/mineral/plastitanium/red,
/area/shuttle/arrival)
"bx" = (
/obj/structure/chair/fancy/shuttle{
	dir = 1
	},
/turf/open/floor/mineral/plastitanium/red,
/area/shuttle/arrival)
"eq" = (
/obj/effect/turf_decal/stripes/line{
	dir = 1
	},
/obj/effect/turf_decal/stripes/corner,
/turf/open/floor/mineral/plastitanium,
/area/shuttle/arrival)
"fr" = (
/obj/structure/shuttle/engine/propulsion{
	dir = 4
	},
/turf/open/floor/plating/airless,
/area/shuttle/arrival)
"hD" = (
/obj/structure/railing/corner{
	dir = 1
	},
/turf/open/floor/mineral/plastitanium/red,
/area/shuttle/arrival)
"jC" = (
/obj/structure/chair/fancy/shuttle,
/obj/machinery/light{
	bulb_colour = "#0F0";
	bulb_emergency_colour = "#0F0";
	bulb_vacuum_colour = "#0F0";
	nightshift_light_color = "#0F0";
	dir = 1
	},
/turf/open/floor/mineral/plastitanium,
/area/shuttle/arrival)
"jJ" = (
/obj/effect/turf_decal/stripes/line{
	dir = 1
	},
/obj/effect/turf_decal/stripes/line,
/turf/open/floor/mineral/plastitanium,
/area/shuttle/arrival)
"jX" = (
/obj/machinery/light{
	bulb_colour = "#0F0";
	bulb_emergency_colour = "#0F0";
	bulb_vacuum_colour = "#0F0";
	nightshift_light_color = "#0F0";
	dir = 1
	},
/obj/structure/chair/fancy/shuttle,
/turf/open/floor/mineral/plastitanium/red,
/area/shuttle/arrival)
"kd" = (
/obj/structure/chair/fancy/shuttle{
	dir = 1
	},
/turf/open/floor/mineral/plastitanium,
/area/shuttle/arrival)
"lm" = (
/obj/effect/turf_decal/stripes/corner,
/turf/open/floor/mineral/plastitanium/red,
/area/shuttle/arrival)
"lS" = (
/obj/effect/turf_decal/stripes/line,
/obj/structure/table,
/obj/item/storage/firstaid/regular,
/turf/open/floor/mineral/plastitanium,
/area/shuttle/arrival)
"nT" = (
/obj/effect/turf_decal/loading_area{
	dir = 4
	},
/obj/effect/turf_decal/bot,
/turf/open/floor/mineral/plastitanium/red,
/area/shuttle/arrival)
"oR" = (
/turf/template_noop,
/area/shuttle/arrival)
"rx" = (
/obj/effect/turf_decal/stripes/line{
	dir = 8
	},
/turf/open/floor/mineral/plastitanium,
/area/shuttle/arrival)
"rO" = (
/obj/structure/shuttle/engine/propulsion/burst/right{
	dir = 4
	},
/turf/open/floor/plating/airless,
/area/shuttle/arrival)
"ts" = (
/obj/effect/turf_decal/stripes/line,
/obj/structure/closet/wardrobe/grey,
/turf/open/floor/mineral/plastitanium,
/area/shuttle/arrival)
"um" = (
/obj/effect/turf_decal/stripes/line{
	dir = 10
	},
/obj/structure/closet/firecloset,
/turf/open/floor/mineral/plastitanium,
/area/shuttle/arrival)
"uK" = (
/obj/machinery/light{
	bulb_colour = "#0F0";
	bulb_emergency_colour = "#0F0";
	bulb_vacuum_colour = "#0F0";
	nightshift_light_color = "#0F0"
	},
/obj/structure/chair/fancy/shuttle{
	dir = 1
	},
/turf/open/floor/mineral/plastitanium/red,
/area/shuttle/arrival)
"vh" = (
/obj/effect/turf_decal/stripes/corner,
/turf/open/floor/mineral/plastitanium,
/area/shuttle/arrival)
"wV" = (
/obj/effect/turf_decal/stripes/end,
/turf/open/floor/mineral/plastitanium,
/area/shuttle/arrival)
"xg" = (
/obj/structure/shuttle/engine/heater{
	dir = 4
	},
/obj/structure/window/reinforced{
	dir = 8
	},
/turf/open/floor/plating/airless,
/area/shuttle/arrival)
"xm" = (
/obj/effect/turf_decal/stripes/corner{
	dir = 1
	},
/turf/open/floor/mineral/plastitanium,
/area/shuttle/arrival)
"zF" = (
/obj/structure/lattice,
/obj/item/stack/marker_beacon{
	anchored = 1;
	icon_state = "markerburgundy-on";
	light_color = "#FA644B";
	light_power = 3;
	light_range = 2;
	name = "landing marker";
	picked_color = "Burgundy"
	},
/obj/structure/lattice/catwalk/over,
/turf/template_noop,
/area/shuttle/arrival)
"zG" = (
/obj/effect/turf_decal/stripes/line,
/turf/open/floor/mineral/plastitanium/red,
/area/shuttle/arrival)
"zH" = (
/obj/structure/shuttle/engine/propulsion/burst/left{
	dir = 4
	},
/turf/open/floor/plating/airless,
/area/shuttle/arrival)
"zS" = (
/obj/effect/turf_decal/stripes/line,
/turf/open/floor/mineral/plastitanium,
/area/shuttle/arrival)
"As" = (
/obj/structure/chair/fancy/shuttle{
	dir = 1
	},
/obj/machinery/light{
	bulb_colour = "#0F0";
	bulb_emergency_colour = "#0F0";
	bulb_vacuum_colour = "#0F0";
	nightshift_light_color = "#0F0"
	},
/turf/open/floor/mineral/plastitanium,
/area/shuttle/arrival)
"AX" = (
/obj/structure/lattice/catwalk/over,
/obj/machinery/door/airlock/grunge,
/turf/open/floor/plating,
/area/shuttle/arrival)
"Dg" = (
/obj/docking_port/mobile/arrivals,
/turf/template_noop,
/area/shuttle/arrival)
"DY" = (
/obj/effect/turf_decal/stripes/corner{
	dir = 4
	},
/turf/open/floor/mineral/plastitanium,
/area/shuttle/arrival)
"Ek" = (
/obj/structure/railing{
	dir = 1
	},
/turf/open/floor/mineral/plastitanium/red,
/area/shuttle/arrival)
"EG" = (
/turf/open/floor/plasteel/stairs{
	dir = 1
	},
/area/shuttle/arrival)
"Fj" = (
/obj/structure/lattice/catwalk/over,
/turf/open/floor/plating,
/area/shuttle/arrival)
"IK" = (
/obj/effect/turf_decal/stripes/line,
/obj/machinery/computer/arcade{
	dir = 1
	},
/turf/open/floor/mineral/plastitanium,
/area/shuttle/arrival)
"Jt" = (
/turf/closed/wall/mineral/plastitanium,
/area/shuttle/arrival)
"Jy" = (
/obj/structure/chair/fancy/shuttle,
/turf/open/floor/mineral/plastitanium/red,
/area/shuttle/arrival)
"Lh" = (
/obj/effect/turf_decal/stripes/line{
	dir = 6
	},
/obj/structure/closet/wardrobe/green,
/turf/open/floor/mineral/plastitanium,
/area/shuttle/arrival)
"Lz" = (
/obj/effect/turf_decal/stripes/line,
/obj/machinery/light{
	bulb_colour = "#0F0";
	bulb_emergency_colour = "#0F0";
	bulb_vacuum_colour = "#0F0";
	nightshift_light_color = "#0F0";
	dir = 8
	},
/turf/open/floor/mineral/plastitanium,
/area/shuttle/arrival)
"Mx" = (
/obj/structure/lattice/catwalk/over,
/turf/template_noop,
/area/shuttle/arrival)
"My" = (
/obj/effect/turf_decal/stripes/line{
	dir = 4
	},
/turf/open/floor/mineral/plastitanium,
/area/shuttle/arrival)
"MO" = (
/obj/effect/turf_decal/stripes/corner,
/obj/effect/turf_decal/stripes/corner{
	dir = 8
	},
/turf/open/floor/mineral/plastitanium,
/area/shuttle/arrival)
"OU" = (
/obj/structure/lattice/catwalk/over,
/obj/machinery/light{
	bulb_colour = "#0F0";
	bulb_emergency_colour = "#0F0";
	bulb_vacuum_colour = "#0F0";
	nightshift_light_color = "#0F0";
	dir = 1
	},
/turf/open/floor/plating,
/area/shuttle/arrival)
"Qn" = (
/obj/structure/window/plastitanium,
/obj/structure/window/plastitanium,
/turf/open/floor/plating,
/area/shuttle/arrival)
"Qq" = (
/obj/structure/lattice,
/obj/structure/lattice/catwalk/over,
/obj/item/stack/marker_beacon{
	anchored = 1;
	icon_state = "markerburgundy-on";
	light_color = "#FA644B";
	light_power = 3;
	light_range = 2;
	name = "landing marker";
	picked_color = "Burgundy"
	},
/turf/template_noop,
/area/shuttle/arrival)
"Sk" = (
/obj/effect/turf_decal/stripes/line,
/obj/structure/closet/emcloset,
/turf/open/floor/mineral/plastitanium,
/area/shuttle/arrival)
"SH" = (
/obj/effect/turf_decal/stripes/line{
	dir = 8
	},
/obj/effect/turf_decal/stripes/corner{
	dir = 4
	},
/obj/machinery/light{
	bulb_colour = "#0F0";
	bulb_emergency_colour = "#0F0";
	bulb_vacuum_colour = "#0F0";
	nightshift_light_color = "#0F0";
	dir = 4
	},
/turf/open/floor/mineral/plastitanium,
/area/shuttle/arrival)
"SU" = (
/obj/structure/window/plastitanium,
/turf/open/floor/plating,
/area/shuttle/arrival)
"Ti" = (
/obj/effect/turf_decal/stripes/corner{
	dir = 8
	},
/turf/open/floor/mineral/plastitanium/red,
/area/shuttle/arrival)
"Tm" = (
/obj/effect/turf_decal/stripes/corner,
/obj/effect/turf_decal/stripes/corner{
	dir = 8
	},
/obj/machinery/light{
	bulb_colour = "#0F0";
	bulb_emergency_colour = "#0F0";
	bulb_vacuum_colour = "#0F0";
	nightshift_light_color = "#0F0"
	},
/turf/open/floor/mineral/plastitanium/red,
/area/shuttle/arrival)
"TY" = (
/obj/structure/lattice,
/turf/template_noop,
/area/shuttle/arrival)
"Uv" = (
/turf/open/floor/mineral/plastitanium/red,
/area/shuttle/arrival)
"Va" = (
/obj/effect/turf_decal/stripes/line{
	dir = 1
	},
/turf/open/floor/mineral/plastitanium,
/area/shuttle/arrival)
"VZ" = (
/obj/effect/turf_decal/stripes/line,
/obj/effect/turf_decal/loading_area,
/obj/effect/turf_decal/bot,
/turf/open/floor/mineral/plastitanium/red,
/area/shuttle/arrival)
"Wd" = (
/obj/effect/turf_decal/stripes/line{
	dir = 4
	},
/obj/machinery/light{
	bulb_colour = "#0F0";
	bulb_emergency_colour = "#0F0";
	bulb_vacuum_colour = "#0F0";
	nightshift_light_color = "#0F0";
	dir = 8
	},
/turf/open/floor/mineral/plastitanium,
/area/shuttle/arrival)
"WJ" = (
/obj/effect/turf_decal/stripes/line,
/obj/machinery/light{
	bulb_colour = "#0F0";
	bulb_emergency_colour = "#0F0";
	bulb_vacuum_colour = "#0F0";
	nightshift_light_color = "#0F0";
	dir = 4
	},
/turf/open/floor/mineral/plastitanium,
/area/shuttle/arrival)
"WP" = (
/obj/effect/turf_decal/stripes/line,
/obj/structure/closet/wardrobe/mixed,
/turf/open/floor/mineral/plastitanium,
/area/shuttle/arrival)
"XM" = (
/obj/structure/lattice/catwalk/over,
/obj/machinery/light{
	bulb_colour = "#0F0";
	bulb_emergency_colour = "#0F0";
	bulb_vacuum_colour = "#0F0";
	nightshift_light_color = "#0F0"
	},
/turf/open/floor/plating,
/area/shuttle/arrival)
"Yf" = (
/obj/effect/turf_decal/stripes/line{
	dir = 1
	},
/obj/effect/turf_decal/stripes/corner{
	dir = 8
	},
/turf/open/floor/mineral/plastitanium,
/area/shuttle/arrival)
"Yp" = (
/obj/structure/railing/corner{
	dir = 4
	},
/turf/open/floor/mineral/plastitanium/red,
/area/shuttle/arrival)
"Yt" = (
/obj/effect/turf_decal/stripes/line,
/obj/structure/closet/wardrobe/black,
/turf/open/floor/mineral/plastitanium,
/area/shuttle/arrival)
"YT" = (
/obj/effect/turf_decal/stripes/line,
/obj/machinery/requests_console{
	department = "Arrival shuttle";
	name = "Arrivals Shuttle console";
	pixel_y = 30
	},
/obj/machinery/light{
	bulb_colour = "#0F0";
	bulb_emergency_colour = "#0F0";
	bulb_vacuum_colour = "#0F0";
	nightshift_light_color = "#0F0";
	dir = 1
	},
/turf/open/floor/mineral/plastitanium,
/area/shuttle/arrival)
"ZU" = (
/obj/effect/turf_decal/stripes/end{
	dir = 1
	},
/turf/open/floor/mineral/plastitanium,
/area/shuttle/arrival)

(1,1,1) = {"
Jt
SU
SU
Qn
SU
Jt
Mx
oR
zF
oR
oR
oR
Qq
oR
"}
(2,1,1) = {"
SU
Jy
Uv
Uv
bx
SU
Mx
oR
TY
oR
oR
oR
TY
oR
"}
(3,1,1) = {"
SU
Jy
Uv
Uv
bx
SU
Mx
oR
TY
oR
oR
oR
TY
oR
"}
(4,1,1) = {"
SU
Jy
Uv
Uv
bx
SU
Mx
oR
TY
oR
oR
oR
TY
oR
"}
(5,1,1) = {"
Jt
jX
nT
nT
uK
Jt
Mx
Mx
Mx
Mx
Mx
Mx
Mx
Mx
"}
(6,1,1) = {"
Jt
SU
bd
bd
SU
Jt
Jt
Jt
Jt
Jt
Jt
Jt
Jt
Jt
"}
(7,1,1) = {"
Jt
vh
My
My
My
Wd
My
My
My
DY
Lz
Ek
lm
Jt
"}
(8,1,1) = {"
SU
zS
Fj
Fj
Fj
Fj
Fj
Fj
Fj
Va
ts
Ek
zG
SU
"}
(9,1,1) = {"
SU
zS
Fj
Jt
Jt
AX
Jt
Jt
OU
Va
WP
Ek
VZ
bd
"}
(10,1,1) = {"
SU
zS
XM
Jt
af
Fj
kd
Jt
Fj
Va
Yt
Ek
zG
SU
"}
(11,1,1) = {"
SU
zS
Fj
Jt
jC
Fj
kd
Jt
Fj
eq
Lh
Ek
Tm
Jt
"}
(12,1,1) = {"
Jt
zS
Fj
Jt
af
Fj
kd
Jt
Fj
jJ
EG
hD
zG
SU
"}
(13,1,1) = {"
Jt
YT
Fj
Jt
af
Fj
kd
Jt
Fj
jJ
EG
Uv
VZ
bd
"}
(14,1,1) = {"
Jt
zS
Fj
Jt
af
Fj
kd
Jt
Fj
jJ
EG
Yp
zG
SU
"}
(15,1,1) = {"
SU
zS
Fj
Jt
af
Fj
As
Jt
Fj
Yf
um
Ek
Tm
Jt
"}
(16,1,1) = {"
SU
zS
XM
Jt
af
Fj
kd
Jt
Fj
Va
Sk
Ek
zG
SU
"}
(17,1,1) = {"
SU
zS
Fj
Jt
Jt
AX
Jt
Jt
OU
Va
lS
Ek
VZ
bd
"}
(18,1,1) = {"
SU
zS
Fj
Fj
Fj
Fj
Fj
Fj
Fj
Va
IK
Ek
zG
SU
"}
(19,1,1) = {"
Jt
MO
wV
Fj
ZU
SH
rx
rx
rx
xm
WJ
Ek
Ti
Jt
"}
(20,1,1) = {"
Jt
Jt
Jt
AX
Jt
Jt
Jt
Jt
Jt
Jt
Jt
Jt
Jt
Jt
"}
(21,1,1) = {"
Jt
Fj
Fj
Fj
Fj
Jt
Mx
Mx
Mx
Mx
Mx
Mx
Mx
Mx
"}
(22,1,1) = {"
Jt
Fj
Fj
Fj
XM
Jt
Mx
oR
TY
oR
oR
oR
TY
oR
"}
(23,1,1) = {"
Jt
Fj
Fj
Fj
Fj
Jt
Mx
oR
TY
oR
oR
oR
TY
oR
"}
(24,1,1) = {"
Jt
xg
xg
xg
xg
Jt
Mx
oR
TY
oR
oR
oR
TY
oR
"}
(25,1,1) = {"
Jt
rO
fr
fr
zH
Jt
Mx
Dg
zF
oR
oR
oR
zF
oR
"}
